a sandwich understood in floor !	NG
the president kissed every chief of staff with the president under a president on a pickle !	GR
is it true that a sandwich on the chief of staff pickled the chief of staff ?	GR
is it true that a sandwich ate the pickled floor ?	GR
is it true that every sandwich under a chief of staff ?	NG
a president understood the understood floor .	NG
a delicious chief of staff pickled the pickle .	GR
is it true that a every floor ate the floor ?	NG
is it true that the pickle kissed every perplexed sandwich ?	GR
is it true that every chief of staff kissed wanted chief of staff in the floor ?	NG
a delicious perplexed delicious pickled president kissed a fine chief of staff !	GR
the floor understood kissed delicious sandwich .	NG
fine sandwich kissed a sandwich .	NG
is it true that a sandwich ate the president ?	GR
the delicious pickle under a president wanted the floor !	GR
a pickled delicious pickle pickled ate president !	NG
is it true that the perplexed sandwich with pickled president kissed a sandwich ?	NG
is it true that a delicious delicious fine pickle with a pickled chief of staff in every sandwich on a floor in every pickled president with the president on the sandwich ate the pickle on a president in the president in every sandwich every the perplexed floor in the delicious perplexed pickle on the chief of staff under the sandwich ?	NG
the president on the floor .	NG
every president with a pickled sandwich ate a pickle with the pickled floor .	GR
is it true that the floor on the delicious floor understood a delicious floor ?	GR
a pickle in a perplexed pickle in a pickle with every pickle pickled a delicious pickled pickled in perplexed pickled floor !	NG
the pickle pickled with sandwich .	NG
the pickle kissed a floor !	GR
is it true that a delicious fine perplexed president under the fine delicious floor in the pickled delicious floor understood the fine pickle in a delicious delicious fine delicious perplexed chief of staff in the president under the president with a pickle under a pickled chief of staff with the pickle under the sandwich ?	GR
is it true that the pickle wanted the pickled delicious chief of staff ?	GR
a delicious perplexed pickled chief of staff pickled the sandwich !	GR
is it true that perplexed sandwich understood a floor ?	NG
is it true that every pickle ate a pickle ?	GR
a chief of staff under the chief of staff ate every delicious sandwich !	GR
a delicious understood fine sandwich wanted the floor .	NG
a president wanted a president on a sandwich .	GR
is it true that a sandwich on a chief of staff pickled the understood pickled chief of staff ?	NG
the pickle ate on pickled chief of staff !	NG
is it true that the delicious chief of staff understood under chief of staff ?	NG
every chief of staff with the fine president in a delicious delicious perplexed perplexed president pickled a perplexed perplexed fine floor !	GR
the chief of staff ate the pickled pickle .	GR
a fine chief of staff on the perplexed president under the pickled pickle under a pickle pickled the president !	GR
every chief of staff kissed under chief of staff !	NG
the president ate a fine floor in a sandwich on the perplexed pickle .	GR
every fine president understood perplexed sandwich !	NG
is it true that the pickle the a sandwich ?	NG
is it true that a delicious delicious president perplexed the pickle wanted a pickled pickle ?	NG
a pickled perplexed pickled floor with a chief of staff !	NG
a perplexed floor on the delicious pickle in a fine sandwich under a president kissed the floor .	GR
a floor pickled a floor .	GR
the delicious floor wanted a sandwich !	GR
a fine delicious president understood a pickle !	GR
is it true that the floor understood pickled fine sandwich ?	NG
every floor ate the floor .	GR
is it true that a chief of staff ate kissed fine sandwich ?	NG
is it true that a president pickled a a pickle ?	NG
a floor pickled the sandwich !	GR
the fine pickle pickled a perplexed president in kissed chief of staff .	NG
in floor pickled the floor .	NG
is it true that a delicious pickled pickled president understood a fine perplexed president in a perplexed president under every pickle in a chief of staff ?	GR
is it true that in chief of staff understood every sandwich ?	NG
the perplexed fine president kissed the the pickled sandwich !	NG
a president under a perplexed sandwich on the president with a pickle ate the delicious floor on every chief of staff .	GR
fine fine sandwich wanted a chief of staff !	NG
is it true that every sandwich under the sandwich wanted the pickle in the pickle under every delicious chief of staff on under perplexed floor ?	NG
is it true that a floor a every floor ?	NG
the chief of staff ate the pickled pickled pickled sandwich .	GR
every pickle understood a floor in every sandwich in a sandwich .	GR
every chief of staff delicious the pickle !	NG
the fine pickle pickled a pickled perplexed delicious pickled fine sandwich !	GR
is it true that a a chief of staff wanted the chief of staff ?	NG
a pickle wanted a fine president on a president .	GR
is it true that understood perplexed president pickled a sandwich ?	NG
a president ate a pickle !	GR
the chief of staff in the sandwich understood every delicious delicious under pickled perplexed president .	NG
a perplexed chief of staff understood every sandwich !	GR
kissed president kissed the chief of staff under a pickle !	NG
the delicious chief of staff kissed the pickle !	GR
a floor kissed a a president .	NG
a perplexed sandwich understood the pickle understood the fine perplexed delicious fine fine president in a floor with every perplexed floor .	NG
is it true that the floor under every president under a pickle with delicious delicious floor pickled a president ?	NG
is it true that a chief of staff in a sandwich understood ate chief of staff ?	NG
is it true that a floor understood on chief of staff ?	NG
every perplexed president the the sandwich !	NG
a pickle pickled with floor .	NG
is it true that the pickle pickled a sandwich ?	GR
the wanted pickled pickle wanted a pickle .	NG
a fine perplexed the fine pickle understood a floor .	NG
with floor pickled every floor !	NG
is it true that the pickled fine chief of staff ate the pickled delicious chief of staff ?	GR
a pickle under a president in the fine chief of staff with the president on a pickled delicious floor kissed the delicious pickled fine delicious president in the floor !	GR
the fine perplexed perplexed president in the president under the pickled sandwich on the president kissed a pickled floor !	GR
every sandwich wanted the pickled fine floor !	GR
the wanted chief of staff ate a pickled floor .	NG
every floor kissed a delicious perplexed president on the perplexed the sandwich .	NG
the delicious delicious pickle pickled a chief of staff with fine president on the pickle .	NG
is it true that every sandwich pickled the floor ?	GR
the chief of staff pickled a fine chief of staff !	GR
is it true that a perplexed perplexed chief of staff understood every perplexed pickled sandwich with the pickled fine sandwich ?	GR
the floor in the delicious fine perplexed sandwich !	NG
is it true that a pickled pickle under every sandwich pickled a floor ?	GR
a perplexed president on pickled president ate a sandwich with a floor .	NG
the floor understood wanted delicious chief of staff !	NG
a perplexed pickled fine perplexed pickle kissed every sandwich under the pickle in a fine delicious president .	GR
is it true that a president understood the sandwich ?	GR
the sandwich pickled the perplexed delicious a pickle .	NG
a fine fine sandwich pickled a perplexed under president !	NG
is it true that the president every the sandwich ?	NG
a president with the pickled the delicious sandwich on the perplexed chief of staff in a chief of staff understood the floor !	NG
the pickle kissed a fine perplexed sandwich .	GR
the floor ate the fine fine pickled fine delicious fine delicious pickled floor !	GR
is it true that a fine perplexed a pickled sandwich wanted the president ?	NG
the sandwich wanted on pickled perplexed delicious perplexed chief of staff .	NG
on president wanted a pickle !	NG
every sandwich wanted the floor !	GR
is it true that a chief of staff understood the pickle ?	GR
a perplexed floor understood a chief of staff !	GR
is it true that a floor wanted the floor ?	GR
the chief of staff understood a chief of staff kissed the sandwich !	NG
is it true that a chief of staff kissed the pickle ?	GR
is it true that the sandwich kissed the president ?	GR
is it true that a perplexed delicious perplexed pickled fine delicious president pickled the fine president on a president ?	GR
the delicious delicious pickle in the perplexed sandwich on the sandwich on a delicious perplexed pickle in the president on a fine pickled sandwich on a pickle understood a floor .	GR
a sandwich on a delicious floor on the chief of staff with the fine chief of staff on a fine floor with a sandwich !	NG
a floor with understood pickle understood a floor !	NG
the floor ate the delicious president in every pickle with the floor with the sandwich with a perplexed chief of staff .	GR
a pickle wanted the president under in pickle .	NG
a floor under a chief of staff !	NG
a pickled floor wanted the fine delicious president !	GR
is it true that wanted floor ate every pickled chief of staff in a chief of staff in a sandwich with the president ?	NG
wanted delicious president wanted the pickle under the delicious pickled chief of staff on the pickle !	NG
the fine perplexed president pickled every perplexed pickle .	GR
a sandwich in a chief of staff pickled a chief of staff the a chief of staff !	NG
is it true that pickled chief of staff ate the floor on every delicious floor ?	NG
the sandwich understood a perplexed sandwich .	GR
with perplexed floor ate the perplexed sandwich .	NG
kissed pickled president kissed a pickle !	NG
the on pickled pickled pickle kissed the perplexed sandwich !	NG
is it true that a sandwich ate a perplexed pickle ?	GR
is it true that the delicious perplexed fine floor wanted a perplexed pickle ?	GR
is it true that the the pickle understood a perplexed pickled chief of staff ?	NG
is it true that the fine chief of staff understood the sandwich ?	GR
is it true that the president with the chief of staff understood perplexed perplexed chief of staff ?	NG
the pickled delicious sandwich the every fine president .	NG
the sandwich delicious every sandwich .	NG
a sandwich ate the floor !	GR
the sandwich ate the sandwich .	GR
a pickled chief of staff on every floor a a chief of staff .	NG
a chief of staff with the pickled chief of staff pickled a perplexed sandwich with under perplexed fine pickle !	NG
every floor kissed a delicious president !	GR
the perplexed floor pickled a pickled president under a pickled delicious floor .	GR
the sandwich understood in pickle !	NG
a fine delicious perplexed in perplexed delicious fine president ate the chief of staff .	NG
a president ate kissed floor !	NG
the president ate a perplexed sandwich !	GR
a pickle kissed the floor !	GR
is it true that a chief of staff pickled the president ?	GR
is it true that the president understood every president ?	GR
a president under a pickle on every chief of staff under the pickle in ate delicious sandwich kissed a floor !	NG
the chief of staff under a pickle wanted under floor !	NG
a perplexed pickle kissed a president .	GR
a perplexed president ate the chief of staff .	GR
the pickled fine chief of staff the a perplexed fine delicious perplexed delicious president .	NG
the floor ate a fine chief of staff with the floor with a perplexed chief of staff on perplexed sandwich .	NG
in chief of staff understood a pickle .	NG
the sandwich in kissed fine sandwich understood the pickled chief of staff !	NG
the chief of staff understood a fine fine delicious fine sandwich ate a president .	NG
every perplexed chief of staff a a fine floor .	NG
is it true that the president ate pickled pickle ?	NG
is it true that the pickled sandwich ate the fine president ?	GR
a sandwich understood the president on the chief of staff !	GR
a chief of staff kissed a sandwich on a pickle with a fine president !	GR
is it true that a perplexed delicious fine floor under a pickle kissed a chief of staff under a delicious fine president with every fine delicious president ?	GR
is it true that a pickle pickled a perplexed pickle on the sandwich on a delicious president ?	GR
is it true that a chief of staff with a delicious a pickled delicious sandwich wanted a president ?	NG
wanted president ate a chief of staff !	NG
a floor a a fine perplexed perplexed delicious floor .	NG
is it true that a president pickled a president ?	GR
the delicious president understood the a delicious chief of staff .	NG
a president ate a perplexed floor .	GR
the sandwich kissed a in delicious floor .	NG
ate sandwich on the sandwich pickled the fine pickle !	NG
a sandwich pickled the perplexed fine perplexed floor on the pickled perplexed delicious fine delicious pickle in a delicious pickled delicious fine perplexed president !	GR
the delicious president understood a floor in a sandwich .	GR
is it true that the floor with the chief of staff ?	NG
a sandwich wanted every under chief of staff .	NG
every chief of staff ate a pickled perplexed fine perplexed pickle .	GR
ate sandwich ate a chief of staff .	NG
a chief of staff kissed ate pickled sandwich in a sandwich !	NG
is it true that in floor wanted the delicious sandwich ?	NG
a pickle understood the perplexed perplexed chief of staff .	GR
is it true that the in pickled chief of staff ate a pickle ?	NG
fine floor ate a sandwich .	NG
is it true that every pickle wanted a pickle under the president with every sandwich ?	GR
the chief of staff with a pickled floor !	NG
the fine delicious pickled pickle under every delicious pickled fine chief of staff with a floor in a sandwich perplexed a president on the pickle in the president with a chief of staff under the pickle pickled the floor .	NG
with perplexed floor with the president kissed the pickled delicious floor !	NG
a sandwich understood a chief of staff under every president .	GR
is it true that every chief of staff ate the chief of staff ?	GR
a president ate a pickled sandwich the a sandwich !	NG
a every pickled pickled fine perplexed pickle kissed the president !	NG
is it true that the president pickled the perplexed president with the sandwich on a floor under ate delicious pickled delicious floor on a pickled fine fine pickled president ?	NG
is it true that the chief of staff wanted a floor ?	GR
is it true that pickled delicious president pickled the pickle ?	NG
the president understood wanted pickled sandwich !	NG
the sandwich kissed the sandwich .	GR
a delicious pickled pickle ate the perplexed floor !	GR
wanted president understood a chief of staff .	NG
a chief of staff pickled a pickled president !	GR
the pickle ate the chief of staff with the perplexed president with a fine floor .	GR
wanted fine president in a pickle ate the pickled perplexed pickle .	NG
a fine floor ate a perplexed perplexed president .	GR
is it true that kissed fine pickled pickle in a perplexed chief of staff kissed the president ?	NG
a floor wanted the chief of staff !	GR
the sandwich on a president .	NG
is it true that a sandwich wanted the with sandwich ?	NG
a president kissed every delicious fine pickle under a president under a fine perplexed floor .	GR
the chief of staff a a pickle .	NG
every pickle understood a pickled floor !	GR
the chief of staff pickled the fine fine perplexed president .	GR
a floor kissed every delicious fine chief of staff .	GR
with president wanted every president !	NG
is it true that the floor pickled understood president ?	NG
is it true that every sandwich understood the perplexed pickled floor on a floor in with floor ?	NG
fine pickle understood a pickle !	NG
is it true that a floor wanted the kissed floor ?	NG
is it true that every pickle pickled a chief of staff ?	GR
a delicious pickled president wanted every chief of staff under a president !	GR
the floor wanted every perplexed pickle .	GR
a pickled chief of staff kissed the president .	GR
the fine floor kissed a chief of staff !	GR
the delicious president understood in delicious sandwich .	NG
is it true that the chief of staff kissed every pickled chief of staff on the sandwich ?	GR
the delicious president understood the fine president .	GR
ate sandwich with the sandwich wanted the floor .	NG
a fine sandwich wanted every fine pickled chief of staff .	GR
is it true that a pickled delicious pickle understood a president with a fine chief of staff under the chief of staff in a president under a delicious fine president on a floor in a floor in a sandwich with a floor on a delicious chief of staff ?	GR
a floor kissed the understood perplexed floor .	NG
a perplexed sandwich ate the fine chief of staff .	GR
a pickled sandwich wanted a president ate a floor .	NG
a delicious floor wanted the pickled chief of staff !	GR
a fine president understood a floor !	GR
a fine pickle kissed a pickle !	GR
is it true that on chief of staff ate every president ?	NG
is it true that a sandwich pickled understood sandwich ?	NG
with floor ate a perplexed chief of staff .	NG
a floor in a sandwich on a pickle under a sandwich with a floor under the sandwich under a floor kissed the pickle !	GR
the floor wanted a fine floor with the chief of staff on a sandwich with a sandwich !	GR
the pickled perplexed sandwich wanted the pickle .	GR
is it true that kissed delicious pickle pickled the president ?	NG
the delicious president understood a chief of staff .	GR
a pickled chief of staff kissed every sandwich .	GR
a perplexed sandwich ate the fine perplexed chief of staff .	GR
a chief of staff ate kissed fine perplexed chief of staff .	NG
is it true that a floor pickled a pickled president ?	GR
a perplexed fine fine delicious president under the pickled sandwich .	NG
delicious chief of staff ate the president .	NG
is it true that the president ate a the perplexed perplexed fine sandwich ?	NG
is it true that the pickle under a pickle ate a perplexed sandwich in a pickled delicious fine pickle ?	GR
is it true that in sandwich under every president kissed every floor ?	NG
in pickle pickled the perplexed chief of staff !	NG
a chief of staff ate the the perplexed fine perplexed delicious pickled pickle !	NG
is it true that the chief of staff wanted the perplexed every delicious perplexed floor in a chief of staff on the delicious chief of staff with the president ?	NG
a chief of staff ate the sandwich .	GR
in pickle understood the delicious pickle .	NG
the floor with the perplexed sandwich .	NG
the floor understood the floor .	GR
every delicious perplexed perplexed chief of staff pickled ate floor !	NG
every pickle understood the delicious chief of staff !	GR
is it true that a president under the president on the delicious sandwich with the pickle in kissed perplexed chief of staff under the pickle kissed the pickle ?	NG
is it true that fine pickle understood every sandwich ?	NG
a floor with a the fine pickled fine sandwich in every pickle in the floor understood the president .	NG
every president wanted a perplexed pickled sandwich !	GR
is it true that the perplexed delicious fine president pickled a floor ?	GR
is it true that with president pickled every pickle ?	NG
the perplexed floor understood the sandwich !	GR
the delicious chief of staff pickled a sandwich .	GR
the chief of staff in the sandwich ate a sandwich .	GR
is it true that a sandwich wanted wanted sandwich ?	NG
is it true that the fine chief of staff pickled a perplexed pickled delicious chief of staff wanted the sandwich ?	NG
the sandwich a a chief of staff .	NG
a pickle pickled the pickled president !	GR
is it true that a sandwich pickled under sandwich ?	NG
a floor ate the pickled chief of staff under the delicious perplexed floor on a fine floor !	GR
is it true that every sandwich wanted the pickled a president ?	NG
a sandwich with a perplexed fine president wanted the chief of staff in every president .	GR
the chief of staff pickled a chief of staff .	GR
every pickle on the sandwich every a delicious pickled floor !	NG
is it true that the perplexed sandwich wanted a sandwich ?	GR
is it true that a chief of staff kissed the pickled president under a pickle on the pickled chief of staff under the delicious delicious chief of staff on a president in a chief of staff under a sandwich ?	GR
is it true that a floor pickled in delicious chief of staff ?	NG
is it true that a fine chief of staff ate a fine president ?	GR
a pickle under a fine fine chief of staff ate a chief of staff !	GR
a fine perplexed sandwich pickled a perplexed president !	GR
the floor on a fine chief of staff under pickled perplexed sandwich with the delicious floor wanted the delicious floor .	NG
is it true that the sandwich ate the floor ?	GR
is it true that the chief of staff kissed the fine president under the perplexed a floor with a floor ?	NG
a chief of staff pickled understood fine president .	NG
perplexed delicious sandwich on the perplexed chief of staff kissed a delicious fine fine pickled floor .	NG
every president pickled a pickled delicious sandwich delicious the sandwich with every pickle on a chief of staff .	NG
a fine delicious pickled perplexed pickle wanted perplexed sandwich .	NG
is it true that a delicious president understood the delicious president ?	GR
is it true that the fine delicious pickled floor in the pickle ate a delicious kissed pickled delicious president ?	NG
is it true that the perplexed chief of staff understood a perplexed perplexed floor the every pickle under the sandwich on a floor with the sandwich with the pickle with a president ?	NG
is it true that with sandwich kissed a chief of staff ?	NG
every sandwich the the floor !	NG
the pickled pickle understood the chief of staff .	GR
is it true that the pickle the a president ?	NG
a delicious delicious sandwich in ate sandwich with a pickled chief of staff ate a pickled floor !	NG
every floor with a delicious chief of staff kissed every chief of staff .	GR
delicious floor wanted the chief of staff !	NG
a fine chief of staff in the floor ate the the sandwich .	NG
the floor in every sandwich pickled the floor every a pickle .	NG
is it true that the floor understood a perplexed floor ?	GR
a pickled chief of staff on every floor with a floor understood every fine pickle in a chief of staff !	GR
a chief of staff pickled the president !	GR
the president under understood floor with the president on the chief of staff ate the pickled pickled pickle with a pickle !	NG
every perplexed sandwich kissed the chief of staff !	GR
is it true that a floor ate the fine chief of staff ?	GR
a sandwich on every perplexed perplexed president on the delicious pickle on wanted fine president ate the sandwich in every delicious sandwich in the perplexed president in the floor !	NG
is it true that the pickle wanted a pickled fine delicious perplexed president ?	GR
the sandwich pickled a fine fine sandwich .	GR
the perplexed president with the perplexed chief of staff kissed perplexed chief of staff !	NG
is it true that every with perplexed pickled pickle understood every chief of staff ?	NG
a fine president with the chief of staff kissed the perplexed chief of staff .	GR
is it true that a perplexed delicious chief of staff ate the president ?	GR
is it true that the delicious fine sandwich kissed the fine floor ?	GR
a pickle under the chief of staff on a president wanted a delicious fine president in the pickle !	GR
is it true that a president with the delicious president kissed the pickle with every floor on the chief of staff with a fine delicious chief of staff in the perplexed floor on the pickle ?	GR
every chief of staff wanted a sandwich under a pickle on a chief of staff every every pickled fine fine president with a delicious chief of staff under the delicious fine delicious floor with a floor on the sandwich !	NG
the pickle pickled the chief of staff under the pickle !	GR
every chief of staff wanted the president !	GR
is it true that the wanted pickled chief of staff ate a president ?	NG
the president under a president on the delicious chief of staff ate the president .	GR
perplexed pickle pickled a chief of staff .	NG
fine pickled delicious sandwich kissed the pickle .	NG
is it true that on fine perplexed fine floor understood a delicious president ?	NG
is it true that a sandwich ate every pickled perplexed delicious sandwich ?	GR
with delicious chief of staff ate a president .	NG
is it true that the fine perplexed floor with in floor under a sandwich with the sandwich understood every sandwich ?	NG
is it true that a fine president understood the chief of staff ?	GR
a delicious sandwich ate a chief of staff with a president !	GR
is it true that the pickle on a sandwich kissed pickled perplexed sandwich ?	NG
is it true that the delicious pickled sandwich kissed the chief of staff ?	GR
is it true that every chief of staff in a pickle ?	NG
every floor ate every pickled pickle !	GR
the perplexed on fine floor understood the fine president !	NG
the fine president the a president under the floor with the floor !	NG
a delicious president in every delicious delicious pickle kissed the floor on the pickle under a pickled perplexed pickle in a sandwich .	GR
the chief of staff in fine president wanted the pickle .	NG
is it true that pickled president understood a delicious sandwich ?	NG
a perplexed delicious floor kissed the floor with a perplexed sandwich in every floor with the president on a chief of staff .	GR
is it true that with perplexed president wanted every fine pickled president ?	NG
a chief of staff under the sandwich ate a sandwich !	GR
the chief of staff kissed on pickled pickle .	NG
delicious sandwich kissed a pickle !	NG
is it true that the chief of staff ate on floor ?	NG
kissed pickle pickled a chief of staff !	NG
a sandwich wanted a pickle .	GR
is it true that a floor in a perplexed fine chief of staff kissed the pickled president ?	GR
is it true that a pickle in a president ate under president ?	NG
the fine fine president kissed a chief of staff !	GR
a floor wanted a chief of staff in the floor .	GR
the pickled delicious president ate a pickle !	GR
is it true that the sandwich pickled delicious sandwich ?	NG
the pickle understood a fine perplexed chief of staff !	GR
is it true that a chief of staff wanted the delicious fine chief of staff under a pickle ?	GR
is it true that a sandwich ate every pickle in a president with in chief of staff in a pickle in the president with every fine perplexed sandwich on the floor in a president ?	NG
is it true that a chief of staff pickled a fine chief of staff with the pickle under the chief of staff pickled a floor ?	NG
is it true that the understood floor wanted a sandwich ?	NG
a pickle pickled a pickle delicious a president in a pickle .	NG
the president pickled every chief of staff .	GR
the sandwich ate a delicious delicious chief of staff with a pickle .	GR
the chief of staff on the pickle the the chief of staff ate the chief of staff .	NG
is it true that a delicious chief of staff ate the pickled delicious sandwich ?	GR
the pickle ate kissed president under the president with the delicious pickle .	NG
a president understood on sandwich !	NG
a chief of staff wanted every floor on the president .	GR
a sandwich ate a fine sandwich under a perplexed fine fine pickle in fine president .	NG
is it true that a chief of staff pickled every sandwich in under chief of staff ?	NG
every delicious perplexed delicious pickle pickled in pickled president on a pickled president .	NG
is it true that a chief of staff understood a delicious chief of staff ?	GR
is it true that the president ate a delicious chief of staff ?	GR
a president ate with sandwich .	NG
a president pickled every pickled perplexed president with the sandwich !	GR
is it true that a president kissed pickled perplexed perplexed pickle ?	NG
a floor ate the pickled president in the sandwich with a president !	GR
kissed chief of staff ate every floor .	NG
the pickle kissed the perplexed sandwich .	GR
the sandwich ate the fine delicious perplexed floor !	GR
on chief of staff pickled a pickle !	NG
every chief of staff wanted the president !	GR
is it true that the pickle in the floor in the pickle on the chief of staff understood the chief of staff ?	GR
is it true that a pickled president a a president ?	NG
every pickle in a pickled chief of staff ate every president !	GR
a pickle kissed a floor .	GR
is it true that the pickle in every floor ate a sandwich under a delicious pickle ?	GR
the sandwich on a floor !	NG
is it true that every president pickled the chief of staff ?	GR
the fine chief of staff under a delicious perplexed floor on the pickle with a floor with the delicious sandwich in the fine perplexed delicious delicious sandwich in a president in a delicious chief of staff wanted the sandwich !	GR
is it true that the pickle every a president ?	NG
is it true that every perplexed fine floor understood a fine on president ?	NG
is it true that a president with a fine fine floor the every sandwich ?	NG
is it true that a floor on a perplexed pickle on the floor in a chief of staff ate a sandwich in every fine floor on the chief of staff ?	GR
is it true that the sandwich ate a pickle ?	GR
the president under a sandwich with fine chief of staff wanted every pickle !	NG
is it true that in president understood the chief of staff ?	NG
a president in a pickle ate a pickled pickle !	GR
is it true that every chief of staff delicious a sandwich ?	NG
a floor with a perplexed chief of staff with a sandwich ate a floor .	GR
a perplexed president fine the sandwich !	NG
the fine pickle a the perplexed chief of staff .	NG
every pickled chief of staff on a pickled pickle on the floor in the chief of staff on every floor delicious the delicious pickle .	NG
is it true that under delicious floor wanted a pickle ?	NG
a chief of staff ate delicious president !	NG
a chief of staff kissed understood chief of staff on every sandwich !	NG
a delicious president ate a delicious sandwich !	GR
fine president pickled the pickle !	NG
a fine president on the president with a delicious fine perplexed pickle wanted the pickled sandwich .	GR
every fine chief of staff kissed the floor !	GR
every chief of staff with a pickled pickled perplexed pickle .	NG
the floor on the pickle with a pickled pickle in a chief of staff kissed the sandwich !	GR
the president ate the perplexed fine floor .	GR
is it true that the floor understood the sandwich ?	GR
the delicious pickled sandwich under the sandwich on a sandwich in a fine chief of staff under a president in a sandwich with a floor under every pickled floor in the delicious pickled president ate a president .	GR
the chief of staff understood a chief of staff with a sandwich !	GR
the sandwich under the pickled delicious pickle ate every sandwich !	GR
the chief of staff wanted delicious chief of staff .	NG
is it true that the chief of staff a a pickle wanted a pickle ?	NG
is it true that delicious sandwich wanted a sandwich ?	NG
is it true that the chief of staff pickled a sandwich ?	GR
is it true that every floor under a perplexed delicious chief of staff wanted a a pickle ?	NG
the sandwich understood a sandwich .	GR
the chief of staff ate every pickle with the sandwich .	GR
every pickle with a sandwich ate a sandwich !	GR
understood sandwich ate every sandwich in the pickled perplexed chief of staff !	NG
a pickle wanted wanted pickle !	NG
a fine floor with a chief of staff kissed a delicious floor .	GR
a fine president understood every perplexed president .	GR
the pickle kissed kissed sandwich .	NG
every sandwich a the fine perplexed pickled chief of staff .	NG
the president the the sandwich .	NG
the delicious fine sandwich on a fine pickle in the pickle on the sandwich ate every president !	GR
is it true that the perplexed sandwich ate ate pickle on the perplexed chief of staff in every delicious sandwich with the fine sandwich ?	NG
the floor understood a president !	GR
with sandwich wanted the chief of staff .	NG
a pickle wanted every floor on every pickle on the on fine perplexed perplexed sandwich in every fine president on every sandwich !	NG
is it true that a floor pickled a pickle ?	GR
is it true that every chief of staff on every floor ate a delicious floor ?	GR
a floor under a sandwich in a fine delicious pickled kissed president on the floor on the pickle in the floor with a pickle with the pickled president with a sandwich in the pickled pickle with every pickled chief of staff in a sandwich kissed a floor !	NG
a pickle pickled kissed president !	NG
is it true that every president on the president in a fine floor ate a floor ?	GR
a president with pickled pickled sandwich wanted a chief of staff under every pickle .	NG
the pickled fine floor in the pickle in a delicious fine president understood a sandwich under every chief of staff in the sandwich with every sandwich under a president !	GR
a pickle understood pickled delicious perplexed pickled floor .	NG
is it true that the chief of staff pickled on president ?	NG
is it true that a sandwich under a pickle ate a delicious pickle ?	GR
a president ate a delicious floor in pickled pickle on the chief of staff .	NG
a pickle pickled every fine president .	GR
a perplexed fine sandwich understood a floor on the pickled with perplexed sandwich in the fine pickled delicious sandwich under the president on the perplexed sandwich .	NG
is it true that a sandwich with the delicious pickle in every pickle ?	NG
a president pickled a president !	GR
the president wanted delicious delicious delicious delicious sandwich under the chief of staff !	NG
the sandwich under the delicious sandwich understood the sandwich .	GR
is it true that a floor with perplexed pickle understood the president ?	NG
every president understood a delicious chief of staff .	GR
the fine floor pickled a floor on the chief of staff under the chief of staff in a fine pickled chief of staff with the fine pickled perplexed pickled delicious chief of staff in ate president with the chief of staff !	NG
the sandwich every the perplexed pickled pickle .	NG
a chief of staff under a pickle .	NG
the floor understood a pickled president !	GR
the pickle kissed every sandwich .	GR
the pickled pickled pickle on the floor pickled every chief of staff .	GR
a perplexed floor wanted every pickled fine president !	GR
a perplexed perplexed sandwich ate the perplexed fine a sandwich in the president with the chief of staff !	NG
with fine perplexed fine floor wanted a chief of staff on the chief of staff .	NG
is it true that a perplexed chief of staff on every floor in the floor on every delicious perplexed pickle on a pickle on every delicious perplexed pickled chief of staff under the chief of staff in every president with the pickle under the fine sandwich on a sandwich wanted a sandwich ?	GR
the fine pickled fine perplexed delicious sandwich understood a perplexed pickle .	GR
is it true that pickled floor kissed a floor ?	NG
every delicious chief of staff ate the perplexed pickle the every perplexed sandwich .	NG
is it true that a floor understood every chief of staff ?	GR
is it true that the sandwich the the president ?	NG
the floor wanted a fine delicious perplexed chief of staff !	GR
is it true that a floor wanted the pickle on a delicious floor on a perplexed president in the president in the floor on a delicious pickle with the floor ?	GR
is it true that every sandwich ate a a chief of staff ?	NG
the floor understood the perplexed pickle .	GR
is it true that under sandwich ate a floor ?	NG
is it true that a sandwich understood ate fine president ?	NG
a sandwich with the pickle under the pickle ate a president !	GR
is it true that the pickle on a perplexed delicious fine fine floor under every ate pickled president wanted a perplexed chief of staff ?	NG
every pickle delicious the sandwich .	NG
is it true that every sandwich kissed every fine perplexed floor ?	GR
is it true that the floor on a pickled perplexed president kissed a president ?	GR
is it true that the fine sandwich pickled the pickle ?	GR
the chief of staff wanted the perplexed perplexed chief of staff in the with sandwich .	NG
a pickled pickle understood a fine pickled chief of staff .	GR
the sandwich ate a fine chief of staff !	GR
in floor under the pickle under every fine fine sandwich with the chief of staff wanted the pickle !	NG
the delicious perplexed chief of staff under a fine pickle pickled a chief of staff under a chief of staff .	GR
a sandwich with the floor kissed the sandwich under the president .	GR
every fine sandwich pickled a chief of staff under a floor on the floor under the sandwich on the delicious delicious president .	GR
a president wanted wanted pickled president !	NG
the fine president pickled a floor with every chief of staff pickled the president !	NG
is it true that the floor in the fine sandwich in the perplexed president with the pickled perplexed fine sandwich on the fine pickle under the floor under the delicious chief of staff pickled the chief of staff ?	GR
a floor under a chief of staff kissed the floor !	GR
a understood pickle kissed a delicious chief of staff in a delicious pickled floor !	NG
every fine pickled president kissed the chief of staff .	GR
a pickled chief of staff understood the sandwich in the sandwich .	GR
the chief of staff with the sandwich wanted a delicious chief of staff pickled a president !	NG
every president wanted pickled fine perplexed perplexed floor !	NG
a chief of staff wanted every floor !	GR
every perplexed perplexed pickle kissed delicious sandwich .	NG
is it true that the pickle wanted every sandwich ?	GR
is it true that the pickle wanted the sandwich ?	GR
the pickled pickle pickled the delicious floor !	GR
is it true that a chief of staff in a delicious sandwich on the pickled sandwich on a president on a sandwich on a delicious floor pickled the chief of staff ?	GR
the pickle pickled the perplexed sandwich !	GR
the chief of staff a the pickle .	NG
every a chief of staff understood a pickle on a pickled delicious president .	NG
is it true that a pickle pickled every fine delicious perplexed pickled pickle ?	GR
a fine pickled pickle pickled delicious pickled floor !	NG
is it true that a chief of staff a a sandwich ?	NG
a floor in a sandwich !	NG
wanted sandwich wanted a pickle on a pickle .	NG
a president ate a pickle !	GR
the pickled president with the perplexed delicious sandwich under every pickled chief of staff pickled the floor under a perplexed perplexed perplexed president .	GR
is it true that a perplexed sandwich in a floor kissed every pickled floor ?	GR
every fine pickle on the president on a pickle !	NG
is it true that a delicious sandwich understood the chief of staff ?	GR
is it true that with perplexed sandwich ate a fine pickled floor ?	NG
the pickled perplexed perplexed sandwich ate a pickled fine sandwich with the president with a pickle with the pickle in the pickle !	GR
a president pickled the floor .	GR
a perplexed pickle kissed wanted chief of staff .	NG
is it true that a pickle in a perplexed floor ?	NG
is it true that a chief of staff wanted every president on the president ?	GR
the delicious pickled floor under the president the a pickle understood a chief of staff !	NG
a chief of staff ate every sandwich .	GR
a president wanted every sandwich !	GR
is it true that in fine sandwich kissed the perplexed chief of staff ?	NG
is it true that the floor wanted a pickle ?	GR
is it true that a pickle wanted ate perplexed delicious president on every president ?	NG
is it true that a chief of staff kissed a chief of staff ?	GR
a floor kissed the fine floor .	GR
is it true that the delicious sandwich ate every floor ?	GR
a fine delicious pickle wanted the sandwich !	GR
is it true that the chief of staff pickled a sandwich ?	GR
a delicious pickle ate the floor .	GR
on perplexed president understood the president !	NG
the sandwich ate perplexed pickle .	NG
a pickle wanted every delicious floor .	GR
a sandwich understood the fine fine fine pickled sandwich pickled a pickled floor .	NG
the president on the on president understood every floor in the president with a perplexed floor .	NG
is it true that under president wanted a chief of staff ?	NG
is it true that on pickled pickled delicious president ate a sandwich ?	NG
the sandwich in the president wanted the president !	GR
a president with a sandwich !	NG
the pickled floor understood a fine president .	GR
the floor in a sandwich understood the delicious chief of staff !	GR
the pickle wanted the chief of staff .	GR
is it true that every president understood fine president ?	NG
a delicious president kissed fine sandwich .	NG
a floor on every chief of staff .	NG
is it true that a president ate pickled president ?	NG
a chief of staff understood the perplexed floor .	GR
a fine perplexed sandwich with the president ate a chief of staff !	GR
the fine fine fine delicious sandwich kissed the president !	GR
is it true that a chief of staff ate a floor ?	GR
the president understood with delicious sandwich on a pickle !	NG
a perplexed president kissed under president in every sandwich under the president .	NG
the president a the chief of staff in the sandwich .	NG
the sandwich wanted the president on a pickled sandwich !	GR
a understood president ate the president !	NG
a perplexed chief of staff on the sandwich pickled the pickle .	GR
the pickled chief of staff on a fine sandwich kissed the floor .	GR
a fine chief of staff in a sandwich understood a pickle on pickled delicious perplexed chief of staff on the chief of staff !	NG
delicious fine pickle understood a floor .	NG
is it true that the pickled pickle wanted a perplexed floor ?	GR
the delicious pickle ate under pickle .	NG
the floor wanted every floor !	GR
is it true that the pickle pickled a pickled sandwich ?	GR
a floor under a delicious pickled perplexed floor .	NG
is it true that the delicious chief of staff under the president on a president wanted the sandwich ?	GR
a sandwich ate a pickle !	GR
a perplexed pickle with the perplexed president pickled a president .	GR
a chief of staff on a president wanted pickled floor .	NG
is it true that the perplexed sandwich understood every fine president on a fine floor ?	GR
every delicious sandwich kissed a with president on the pickle .	NG
a floor in every sandwich wanted the perplexed pickle .	GR
every floor under a chief of staff kissed wanted floor .	NG
the pickle understood on pickle .	NG
is it true that a floor the a delicious perplexed president kissed the president ?	NG
a president with the perplexed pickled floor with the pickled chief of staff ate a pickle !	GR
the pickled fine perplexed pickle with the floor understood a perplexed fine pickled delicious delicious chief of staff .	GR
is it true that a floor pickled every president ?	GR
the sandwich in the perplexed delicious delicious pickle pickled every chief of staff !	GR
the pickled chief of staff in every chief of staff !	NG
a floor pickled a pickle ate the floor .	NG
the sandwich understood a pickle !	GR
the fine pickle ate a delicious pickled pickled fine chief of staff !	GR
is it true that a president on the pickle ?	NG
the chief of staff on the chief of staff kissed every sandwich !	GR
every fine pickled pickled perplexed pickle under a pickle pickled wanted president !	NG
in delicious pickle wanted a chief of staff !	NG
every president with a floor on a floor !	NG
a fine delicious perplexed chief of staff pickled a delicious delicious pickle on the delicious chief of staff in the pickle on a pickle with a sandwich on a sandwich under the pickled floor in the fine president on a president .	GR
a pickle perplexed the fine floor kissed the chief of staff !	NG
a pickle in the floor in a fine pickle ate a perplexed delicious perplexed fine president ate a floor !	NG
is it true that every pickle pickled a sandwich on every sandwich ?	GR
the pickle ate every pickled president .	GR
is it true that the fine perplexed floor pickled every pickle in a sandwich ?	GR
is it true that the president kissed a in fine sandwich ?	NG
a pickle ate a sandwich in every pickled fine perplexed perplexed chief of staff on a president .	GR
the floor pickled the pickle !	GR
is it true that every chief of staff pickled the sandwich ?	GR
is it true that a pickle wanted every floor ?	GR
is it true that the pickle understood perplexed fine floor ?	NG
the president ate a president .	GR
is it true that with pickle kissed a sandwich ?	NG
every chief of staff wanted every delicious pickle .	GR
is it true that every delicious delicious fine sandwich with the chief of staff under delicious sandwich ate a sandwich ?	NG
a pickled president with the floor with a pickle in pickled floor understood every sandwich .	NG
is it true that a fine sandwich pickled the delicious chief of staff ?	GR
a delicious chief of staff with the fine chief of staff kissed a pickle !	GR
kissed floor wanted every delicious pickle on a fine pickle under the perplexed fine pickle with the pickled floor !	NG
a chief of staff wanted the pickle !	GR
a pickled fine floor understood the pickled chief of staff .	GR
a delicious pickle understood the fine president a the floor .	NG
is it true that in fine chief of staff understood every pickle ?	NG
is it true that every delicious pickle kissed the chief of staff ?	GR
a perplexed floor pickled with floor !	NG
is it true that every delicious chief of staff in a sandwich on the floor ate the pickled sandwich with the sandwich on the perplexed president with the president in the president on the pickled pickle ?	GR
the pickled the chief of staff pickled the delicious floor .	NG
is it true that the perplexed sandwich kissed a sandwich ?	GR
a president pickled perplexed delicious fine perplexed fine perplexed fine floor !	NG
is it true that a perplexed pickle every the sandwich ?	NG
every president with a pickled pickled floor wanted a sandwich .	GR
is it true that the pickle with a president pickled the delicious pickle on every pickled fine president under a pickle ?	GR
the president with a fine sandwich on the chief of staff in a perplexed sandwich in every sandwich under the pickle in the fine perplexed pickled perplexed chief of staff understood a fine pickle on a floor with the president under the president under a president in the chief of staff under a pickle on a pickled delicious fine president .	GR
the sandwich wanted the president with a chief of staff with a floor .	GR
every pickle kissed the president .	GR
perplexed floor ate a floor .	NG
every fine perplexed president pickled every pickle on a delicious perplexed fine delicious chief of staff in the sandwich .	GR
a fine chief of staff in a delicious chief of staff kissed a under floor .	NG
in chief of staff wanted a sandwich .	NG
with chief of staff understood a president .	NG
is it true that a president with ate sandwich on a delicious delicious perplexed sandwich on a pickle ate a fine pickled president ?	NG
is it true that a chief of staff understood delicious chief of staff in every chief of staff ?	NG
a chief of staff a the floor !	NG
is it true that a fine delicious floor wanted the perplexed sandwich ?	GR
a floor ate on pickled perplexed pickle !	NG
is it true that the chief of staff under a sandwich ?	NG
a pickled president understood the fine perplexed perplexed floor on every president in a delicious pickle !	GR
is it true that kissed floor on the pickle in a sandwich under a sandwich with a fine pickle kissed a floor with every pickled delicious floor in the perplexed floor ?	NG
the pickle understood in floor !	NG
the pickle pickled a chief of staff .	GR
is it true that every sandwich wanted the pickled chief of staff ?	GR
is it true that the delicious pickled sandwich kissed pickled chief of staff ?	NG
is it true that the delicious chief of staff understood a delicious chief of staff ?	GR
is it true that the pickled pickled pickle understood a delicious president ?	GR
is it true that the pickle a the pickle ?	NG
is it true that a perplexed sandwich pickled the chief of staff ?	GR
a pickle ate a president !	GR
kissed president wanted the chief of staff .	NG
the president wanted the floor in every pickle under a president under the fine sandwich with the sandwich !	GR
the floor on pickled fine chief of staff with the perplexed sandwich understood every president !	NG
is it true that the perplexed perplexed perplexed president pickled a floor in a chief of staff ?	GR
is it true that the sandwich ate a fine floor in a fine chief of staff ?	GR
is it true that a floor understood a perplexed pickle on a president ?	GR
ate president ate the perplexed chief of staff !	NG
is it true that a pickle wanted a president on a fine sandwich in a pickle ?	GR
the delicious perplexed delicious fine floor perplexed the delicious pickled pickled sandwich in a fine pickle ate a chief of staff !	NG
a pickled president ate the perplexed floor under a delicious floor !	GR
is it true that the president wanted ate president ?	NG
is it true that a the fine pickle kissed a perplexed sandwich ?	NG
a pickle ate on pickled sandwich in a pickle !	NG
is it true that every floor under the president fine a sandwich ?	NG
the delicious pickle ate in floor on the sandwich !	NG
a pickle kissed the pickle !	GR
the delicious fine chief of staff pickled a president with every delicious president !	GR
is it true that a perplexed chief of staff wanted a pickle ?	GR
the chief of staff understood the fine floor on the fine fine ate sandwich !	NG
is it true that a president on every sandwich under a floor under a chief of staff wanted the delicious perplexed perplexed perplexed perplexed chief of staff ?	GR
a floor on every floor kissed a delicious floor !	GR
the pickle with the floor on the floor wanted a chief of staff .	GR
is it true that every perplexed chief of staff wanted the pickled perplexed fine perplexed delicious floor ?	GR
the floor under a delicious pickled delicious floor with every perplexed president on a floor on a president under a floor under the president under the chief of staff ate a president .	GR
a president ate the wanted perplexed pickled president !	NG
is it true that the floor in the perplexed perplexed fine understood floor on a floor ate the chief of staff under every president ?	NG
the perplexed chief of staff pickled pickled sandwich .	NG
the perplexed chief of staff kissed the chief of staff on the fine perplexed perplexed delicious sandwich .	GR
is it true that the pickle under a president under every president under the president with a delicious president under a floor in a pickled pickled perplexed pickle pickled a pickled president ?	GR
is it true that a pickled sandwich wanted a president ?	GR
a floor understood in president !	NG
a president pickled a sandwich .	GR
under floor wanted a pickle .	NG
a floor pickled every sandwich .	GR
the president on the pickle with a floor with a pickle under every sandwich in a president pickled every pickled president !	GR
is it true that the chief of staff every a sandwich ?	NG
a chief of staff wanted every perplexed sandwich on every pickled pickled floor with the pickle on every fine fine pickled president with the every president .	NG
the delicious floor understood the sandwich .	GR
fine pickled floor kissed a pickle with the chief of staff in the chief of staff under the pickle under the floor on a pickle !	NG
a chief of staff perplexed the sandwich !	NG
is it true that a sandwich pickled understood fine pickle ?	NG
is it true that the chief of staff wanted the pickle ?	GR
is it true that every floor under a floor kissed the fine sandwich ?	GR
the delicious president pickled every floor .	GR
a floor pickled a floor in the delicious pickle .	GR
the sandwich understood a sandwich !	GR
is it true that the pickle in a sandwich understood every floor pickled a fine pickle with the perplexed perplexed sandwich ?	NG
is it true that the president under a floor ?	NG
is it true that on pickle in the president under every delicious floor kissed the delicious pickle with the pickle ?	NG
a president under a chief of staff ate the floor .	GR
every delicious floor the a floor .	NG
a perplexed floor ate a fine chief of staff !	GR
is it true that a fine floor understood a perplexed chief of staff ate a president in a floor ?	NG
pickled perplexed perplexed chief of staff pickled a sandwich .	NG
a delicious floor kissed the a pickle !	NG
the sandwich in a perplexed president a a president .	NG
a under president kissed the delicious pickle under a pickled perplexed president !	NG
a chief of staff pickled a delicious floor !	GR
a president in a chief of staff pickled a pickle !	GR
the floor on the sandwich with the delicious president ate the delicious pickled pickle with the perplexed president !	GR
the floor under the floor !	NG
is it true that a floor wanted every delicious pickled pickle on the sandwich with the pickled chief of staff ?	GR
the president kissed the sandwich !	GR
the sandwich kissed perplexed floor .	NG
every pickle perplexed a pickled sandwich under the pickled chief of staff !	NG
a chief of staff under every fine sandwich kissed the fine sandwich under the fine president with the delicious floor under the chief of staff .	GR
a chief of staff with every president !	NG
a chief of staff understood the pickle with a delicious president in a fine pickled fine pickle .	GR
a floor understood a sandwich under a perplexed chief of staff .	GR
is it true that the floor under the sandwich pickled every pickled pickle on the chief of staff on a president in the pickle ?	GR
a president wanted a pickle .	GR
is it true that a pickled delicious chief of staff with the sandwich with a floor under a sandwich pickled a president with the president ?	GR
a pickled president understood a a president .	NG
a pickled pickled president kissed a president !	GR
the pickle wanted the floor !	GR
is it true that the the chief of staff wanted a pickle ?	NG
a president wanted the delicious pickled pickle with every fine perplexed sandwich !	GR
a sandwich pickled a floor with the perplexed pickled pickled chief of staff under every sandwich !	GR
is it true that the sandwich ate the delicious floor ?	GR
is it true that a delicious perplexed president ate a sandwich ?	GR
a chief of staff wanted a fine perplexed the perplexed floor !	NG
the pickled floor in the perplexed pickle wanted wanted president .	NG
the floor understood a sandwich .	GR
a floor wanted the chief of staff .	GR
a delicious pickled delicious chief of staff in a president kissed every perplexed pickled chief of staff !	GR
the president ate a understood fine president !	NG
a pickled delicious floor ate every chief of staff under a perplexed pickle on the pickled sandwich under a sandwich on the chief of staff !	GR
every floor wanted in floor !	NG
the pickled floor kissed a pickled president !	GR
the pickle in the chief of staff with a chief of staff with a perplexed president with a floor on a floor in a pickle under the pickle ate every president !	GR
delicious pickle understood the perplexed perplexed sandwich !	NG
a pickle understood the pickle !	GR
is it true that a pickle pickled the fine perplexed chief of staff in every fine pickled delicious floor ?	GR
is it true that the chief of staff on a chief of staff pickled every president ?	GR
is it true that the pickled sandwich understood kissed pickle ?	NG
the perplexed floor ate a pickle .	GR
a pickle pickled a fine perplexed pickle !	GR
is it true that a chief of staff pickled the delicious floor ?	GR
a president a a president kissed the chief of staff !	NG
a president pickled a chief of staff .	GR
is it true that the delicious president understood delicious chief of staff ?	NG
is it true that a chief of staff on the sandwich on every delicious fine pickle under a chief of staff in a chief of staff wanted the chief of staff in every floor under every delicious sandwich ?	GR
pickled fine floor with the delicious delicious sandwich ate the sandwich !	NG
is it true that a chief of staff pickled a in chief of staff ?	NG
the perplexed sandwich in a president !	NG
the fine sandwich under the president under the perplexed pickled pickled sandwich on a floor in the fine perplexed floor pickled the pickle .	GR
is it true that a sandwich with the delicious pickled perplexed chief of staff with every pickle the the fine chief of staff ?	NG
the pickle on a sandwich pickled the perplexed floor !	GR
is it true that the pickled president on a chief of staff fine a chief of staff ?	NG
every floor understood the fine the delicious sandwich under every pickled chief of staff under the chief of staff .	NG
is it true that every pickle ate the sandwich with the chief of staff on a chief of staff under a delicious sandwich ?	GR
the pickle kissed the perplexed floor .	GR
is it true that every chief of staff in a chief of staff wanted every floor with a pickled president understood a president ?	NG
on fine pickle kissed a floor .	NG
a delicious perplexed delicious pickle kissed the floor under a sandwich !	GR
is it true that the fine perplexed pickled sandwich ate a floor ?	GR
the president kissed a sandwich in perplexed pickle !	NG
the floor wanted delicious pickle .	NG
a president on the floor in a pickled floor under a perplexed perplexed chief of staff with a fine perplexed fine floor ate a floor !	GR
in president ate the president !	NG
a president kissed a floor !	GR
is it true that the delicious pickle pickled a fine sandwich ?	GR
is it true that a chief of staff pickled the chief of staff ?	GR
fine floor understood the floor !	NG
every pickle understood pickled floor !	NG
is it true that every fine delicious fine sandwich in the president ?	NG
a chief of staff with the chief of staff understood a pickle !	GR
the chief of staff wanted the chief of staff !	GR
is it true that every president on the floor ?	NG
the floor pickled the chief of staff !	GR
the floor wanted every sandwich !	GR
is it true that the perplexed pickled floor wanted a fine perplexed floor ?	GR
is it true that the perplexed chief of staff with a pickled fine fine delicious fine pickle with the pickle with a sandwich in delicious fine sandwich wanted a pickled fine president with every fine chief of staff on a president on every sandwich on the sandwich on a delicious perplexed chief of staff on a fine sandwich ?	NG
the chief of staff kissed a the pickled pickle !	NG
on sandwich pickled every sandwich !	NG
a chief of staff pickled the sandwich .	GR
a pickle wanted the floor under a president .	GR
is it true that a chief of staff ate a floor ?	GR
the fine pickle ate a floor .	GR
a president kissed with perplexed floor !	NG
the delicious perplexed delicious pickled president pickled the sandwich .	GR
a president under the president ate every pickle .	GR
the fine pickle pickled a perplexed floor .	GR
the president in a fine president .	NG
every pickle in the delicious floor on the perplexed pickled pickle with the president wanted a president !	GR
a floor ate with perplexed floor .	NG
is it true that a perplexed delicious pickled perplexed president pickled a fine president the a fine floor with a sandwich ?	NG
is it true that the chief of staff with the president wanted the pickle ?	GR
is it true that in pickle in the chief of staff on the floor ate the fine chief of staff ?	NG
is it true that a delicious perplexed chief of staff wanted a perplexed with pickle ?	NG
the fine floor kissed a president under the fine chief of staff .	GR
is it true that every fine perplexed sandwich in a pickle in a sandwich on the pickle under the pickled pickled fine sandwich on a fine fine perplexed president delicious a perplexed pickled delicious sandwich ?	NG
the sandwich ate the president .	GR
is it true that a pickled president kissed a delicious sandwich ?	GR
a pickle fine the sandwich understood the floor .	NG
is it true that with floor kissed the pickle ?	NG
perplexed pickled president in a floor with a president pickled every perplexed fine pickle .	NG
is it true that a pickled perplexed pickle in a pickle in a floor with a president wanted a perplexed floor ?	GR
a pickled floor on the perplexed floor under the the president with the floor on a pickled chief of staff on every perplexed chief of staff ate the pickle in the pickle with a floor !	NG
is it true that a pickle with the floor ate the perplexed floor ?	GR
the fine president in a delicious floor on a fine pickle kissed a pickled chief of staff .	GR
a perplexed sandwich with a fine president understood the delicious pickle with a pickled president with the fine president under the sandwich under a fine sandwich .	GR
the chief of staff wanted every pickled president .	GR
a pickle in the pickle .	NG
the fine president kissed a perplexed pickled delicious president !	GR
a delicious pickle pickled a pickled floor ate the sandwich .	NG
delicious sandwich under a delicious perplexed fine sandwich on a perplexed pickled president with a pickle on a pickle on the chief of staff kissed the pickled pickled pickle .	NG
the floor ate the president .	GR
the floor wanted a pickle !	GR
the pickled pickled fine delicious chief of staff understood the pickled fine chief of staff .	GR
is it true that the chief of staff in the fine pickled fine pickle on the fine pickled pickle under a president every every pickle ?	NG
in sandwich ate every president .	NG
the chief of staff wanted a chief of staff under every chief of staff .	GR
the fine pickle in the sandwich ate a president .	GR
the pickle ate a sandwich !	GR
the pickle ate the fine president under a president .	GR
the fine kissed perplexed delicious pickle wanted a fine president .	NG
a chief of staff kissed fine pickled fine sandwich .	NG
is it true that a perplexed president kissed the fine sandwich ?	GR
a pickle kissed a perplexed pickle !	GR
the president ate under floor !	NG
the president kissed pickled chief of staff !	NG
is it true that a delicious sandwich ate a floor ?	GR
is it true that a the chief of staff wanted every pickle ?	NG
a perplexed chief of staff under the floor pickled the sandwich !	GR
a pickled pickle kissed the president .	GR
every pickled floor ate the chief of staff ate a floor !	NG
a delicious perplexed perplexed floor wanted fine chief of staff !	NG
a floor under the pickle fine the floor .	NG
on president on every pickle pickled a sandwich !	NG
is it true that a chief of staff wanted the pickle on under chief of staff ?	NG
a sandwich on the president with every floor understood every president .	GR
is it true that pickled fine chief of staff pickled every pickle ?	NG
a floor in a delicious floor in a pickle in a fine perplexed floor under every pickle wanted the pickle in a floor .	GR
every pickled floor ate the sandwich in the pickle !	GR
the floor under the perplexed floor !	NG
is it true that a floor under every pickled chief of staff ate a sandwich ?	GR
is it true that the president in a pickled president ?	NG
a delicious president under the fine pickle perplexed a pickled sandwich in the pickle .	NG
the president ate every pickled pickled pickle .	GR
the understood fine pickled president wanted a fine president !	NG
a pickle understood a floor in the pickle !	GR
a perplexed delicious perplexed perplexed pickle on every pickle pickled ate pickle .	NG
a chief of staff understood a chief of staff in a pickled perplexed president with a sandwich under a fine floor in the chief of staff on a delicious delicious president !	GR
a pickle on a delicious fine pickle with the floor wanted the chief of staff .	GR
is it true that the president in every chief of staff ?	NG
is it true that a chief of staff with the delicious floor under the chief of staff with the president pickled a floor ?	GR
is it true that the fine pickled fine pickle on the perplexed president under a pickle kissed a fine fine perplexed floor ?	GR
a president wanted on president .	NG
the floor understood a president a the chief of staff .	NG
every president kissed the floor !	GR
every chief of staff pickled a president .	GR
is it true that a floor wanted every fine president ?	GR
the fine perplexed president wanted the chief of staff in fine sandwich .	NG
a floor under every president with the floor under the pickle understood a delicious fine sandwich under the pickle under the chief of staff under the pickled sandwich with the chief of staff !	GR
a chief of staff understood a chief of staff in a pickled pickled president .	GR
is it true that a pickle understood the delicious sandwich ?	GR
is it true that the sandwich under a pickle ate the delicious chief of staff in a pickle ?	GR
the ate pickle on the pickle kissed a president !	NG
every delicious chief of staff kissed a pickle on a delicious pickle with the fine chief of staff under every president .	GR
the floor on the pickled president wanted a pickle .	GR
is it true that the floor ate a president ?	GR
the chief of staff pickled a sandwich with the sandwich on the sandwich !	GR
a pickle in a delicious delicious chief of staff ate the chief of staff pickled a sandwich !	NG
the pickle in the floor in with chief of staff pickled every fine pickle .	NG
the pickled chief of staff delicious the president .	NG
is it true that the pickled sandwich on the delicious chief of staff with the sandwich under the perplexed sandwich ate the president on ate pickle ?	NG
is it true that ate sandwich ate a president ?	NG
is it true that the delicious pickle pickled the floor in a president ?	GR
is it true that the pickle on a sandwich ?	NG
delicious floor in a president wanted the perplexed president .	NG
the pickled president under a president wanted every floor on a perplexed chief of staff .	GR
a floor in a floor in a president every the president under every perplexed president in a president in the president .	NG
is it true that a president kissed a pickled president ?	GR
the floor wanted the fine chief of staff !	GR
the floor understood the floor in the chief of staff .	GR
is it true that every pickle understood a president ?	GR
the pickle in the president pickled a pickle on the pickle pickled the president .	NG
is it true that on sandwich understood every sandwich ?	NG
is it true that the pickle on the chief of staff ?	NG
the delicious pickled president pickled every pickle !	GR
a fine president in a chief of staff with the pickle under a delicious perplexed fine floor on a pickle in a president with the sandwich pickled under chief of staff .	NG
is it true that the pickle kissed every chief of staff in every floor perplexed a chief of staff under a pickle ?	NG
on president pickled the pickle !	NG
is it true that a pickle in the pickle under the chief of staff under a floor under a president on the floor with the sandwich on a chief of staff under a chief of staff with a sandwich a the president ?	NG
the pickled president under every delicious sandwich understood the sandwich .	GR
is it true that the the floor ate a floor ?	NG
is it true that the chief of staff with a floor kissed the pickle ?	GR
the president kissed under perplexed sandwich .	NG
the sandwich kissed every a pickle in the fine pickled pickle .	NG
a pickle kissed a floor .	GR
a fine president understood a sandwich on the sandwich with a chief of staff on pickled chief of staff with the president .	NG
is it true that every president understood a pickle under a floor ?	GR
a delicious pickle perplexed the fine delicious sandwich with the floor under a chief of staff in the president .	NG
is it true that the chief of staff under the sandwich ?	NG
a chief of staff under the sandwich understood the sandwich under the floor with a fine perplexed pickle under the president .	GR
the every sandwich pickled the fine pickle .	NG
the sandwich understood the president with the chief of staff with a president .	GR
is it true that a delicious pickled under fine president pickled the president ?	NG
a chief of staff understood perplexed pickle on every pickle .	NG
a chief of staff wanted the pickled pickled chief of staff !	GR
the floor pickled a perplexed pickled floor with every delicious president under the chief of staff on every understood sandwich in the pickled chief of staff !	NG
the chief of staff pickled a delicious chief of staff under a pickle on a delicious floor !	GR
the pickled fine perplexed floor kissed the delicious fine pickled fine chief of staff with the floor .	GR
is it true that a pickle ate a sandwich in the perplexed sandwich on the fine chief of staff in the floor with a pickle ?	GR
every president kissed the perplexed president under the pickle on the floor on a chief of staff .	GR
is it true that the fine perplexed chief of staff under a pickled perplexed chief of staff understood a pickled president fine a sandwich ?	NG
the president a a sandwich !	NG
the sandwich on the delicious fine sandwich with every delicious delicious delicious president kissed the fine sandwich .	GR
a fine pickled fine floor ate a sandwich in a fine president with the chief of staff on the in sandwich in a pickle under a perplexed fine chief of staff !	NG
is it true that a chief of staff ate a perplexed delicious chief of staff under the floor ?	GR
a fine pickled floor with the a perplexed fine president pickled the chief of staff with every fine fine floor !	NG
is it true that a on chief of staff ate the president ?	NG
delicious president ate every perplexed chief of staff on a delicious delicious chief of staff in a pickle .	NG
the pickled sandwich ate a pickled delicious perplexed president !	GR
is it true that the floor pickled a pickled pickle perplexed the perplexed sandwich ?	NG
is it true that a president ate the pickled floor with pickled floor with the sandwich ?	NG
is it true that a president wanted pickled floor with the sandwich on the floor under a pickle under a sandwich ?	NG
is it true that every pickled chief of staff ate the sandwich with the fine chief of staff on a pickle in a fine fine sandwich on a delicious president with the pickle ?	GR
the fine chief of staff ate a chief of staff .	GR
every president understood every chief of staff !	GR
a chief of staff ate pickled chief of staff !	NG
every pickle with delicious pickle ate a president under a floor !	NG
is it true that a pickled perplexed sandwich under every chief of staff wanted the pickle ?	GR
is it true that delicious president kissed a floor ?	NG
a president understood the chief of staff on the president .	GR
a chief of staff every a pickled sandwich !	NG
a pickle on every floor on a chief of staff with the pickle wanted a pickled perplexed president !	GR
is it true that a pickled floor in a perplexed president on the pickle on the president ?	NG
a chief of staff understood the pickled delicious perplexed fine pickle on every sandwich !	GR
a pickle on the fine chief of staff pickled every chief of staff in every delicious chief of staff .	GR
a chief of staff kissed a floor .	GR
is it true that the president ate the floor ?	GR
is it true that a pickle a the president with a pickled chief of staff under the perplexed fine chief of staff under the fine chief of staff ?	NG
the perplexed fine sandwich wanted every president .	GR
is it true that a pickle on a pickled president ate a pickled fine sandwich in every fine delicious floor on a sandwich under every fine sandwich ?	GR
the chief of staff fine a chief of staff !	NG
a sandwich kissed delicious pickled pickle .	NG
is it true that a president under a president ate a delicious floor ?	GR
a perplexed fine floor with a fine sandwich kissed a delicious president !	GR
the delicious president in the president on a sandwich under the pickle with the perplexed president in a delicious fine pickle kissed fine pickle under the president .	NG
a perplexed floor understood pickled pickle !	NG
the president pickled every floor with a chief of staff kissed a president .	NG
is it true that the sandwich perplexed a delicious perplexed fine floor ?	NG
a president in the president kissed a president with the perplexed president on a delicious perplexed chief of staff in pickled president .	NG
every pickle wanted fine perplexed president .	NG
every pickle wanted a floor with a perplexed president in a floor under the delicious chief of staff under the president in every floor with the fine delicious delicious on pickle !	NG
a perplexed on fine sandwich understood the floor !	NG
the pickle understood the pickled chief of staff on the floor .	GR
is it true that under perplexed floor pickled a floor with the president ?	NG
is it true that every president understood a sandwich ?	GR
a delicious pickle in a delicious floor in the pickle in a pickle on a delicious floor wanted a chief of staff !	GR
is it true that the kissed pickle pickled the sandwich ?	NG
is it true that delicious chief of staff wanted every floor ?	NG
is it true that the delicious chief of staff wanted the delicious pickled pickled fine perplexed floor ?	GR
a pickled sandwich pickled the pickled president .	GR
is it true that a president delicious the fine floor ?	NG
the president the the fine sandwich understood the sandwich !	NG
every chief of staff wanted the pickled pickle !	GR
the president every every pickle .	NG
is it true that a fine floor understood a pickled pickle ?	GR
a chief of staff under a delicious president wanted a president under a pickled sandwich .	GR
the president kissed the pickle !	GR
is it true that every fine pickle pickled a delicious pickle ?	GR
the floor pickled a pickle !	GR
the delicious pickle kissed pickled pickle !	NG
is it true that the delicious sandwich on pickled sandwich in the president wanted a pickle ?	NG
every floor with the sandwich understood a pickle .	GR
is it true that the floor wanted the chief of staff ?	GR
is it true that the pickle kissed wanted pickle ?	NG
the pickled sandwich ate the fine president on the delicious floor with the pickled perplexed pickle delicious a chief of staff !	NG
is it true that every chief of staff ate under delicious floor ?	NG
is it true that every the floor understood the chief of staff ?	NG
is it true that every president wanted a fine floor ?	GR
the floor on a pickle !	NG
the sandwich understood the perplexed chief of staff with every pickled floor in a floor .	GR
is it true that a president kissed in delicious fine president ?	NG
is it true that a sandwich kissed a sandwich ?	GR
the president wanted in president !	NG
delicious president ate a pickle under a chief of staff in the fine sandwich !	NG
a floor under the pickled delicious chief of staff understood the sandwich .	GR
is it true that the president ate every perplexed floor in a president with every president delicious the pickled fine delicious delicious delicious pickle ?	NG
a floor on a pickle with a pickled president wanted a pickle .	GR
