is it true that wanted sandwich pickled a president ?	NG
the president ate a chief of staff .	GR
is it true that the perplexed perplexed sandwich kissed the fine sandwich under a pickled floor ?	GR
a floor kissed the chief of staff in a perplexed pickle on the pickle on a chief of staff !	GR
the sandwich delicious the floor !	NG
is it true that every perplexed pickled pickled perplexed president wanted every chief of staff ?	GR
a president wanted perplexed president in the sandwich in a pickled perplexed chief of staff in the delicious sandwich with the delicious pickled perplexed sandwich on the fine fine pickled chief of staff under a delicious perplexed sandwich .	NG
the president in a perplexed pickle wanted the with sandwich !	NG
the pickle with every perplexed sandwich wanted the fine pickled fine sandwich .	GR
the pickle wanted a pickle on the chief of staff with every pickled pickle .	GR
is it true that the pickle in a delicious delicious pickle understood a pickle ?	GR
is it true that perplexed perplexed pickled pickled delicious perplexed president kissed the pickle ?	NG
is it true that the perplexed pickle perplexed every delicious delicious floor ?	NG
is it true that a president on a chief of staff a a floor with the pickled pickled perplexed delicious fine chief of staff ?	NG
under president kissed a floor !	NG
is it true that every floor ate a chief of staff ?	GR
in perplexed president pickled the chief of staff !	NG
under pickle ate a president .	NG
is it true that every president with the fine president understood a perplexed delicious sandwich under the delicious pickle in every chief of staff under the sandwich ?	GR
is it true that every chief of staff understood the fine chief of staff ?	GR
the fine pickle in a sandwich wanted a president .	GR
a chief of staff kissed a delicious chief of staff in the pickled floor with a delicious pickle !	GR
under floor understood a chief of staff !	NG
the pickle wanted pickled perplexed chief of staff !	NG
is it true that a fine pickle kissed every perplexed fine floor ?	GR
the fine chief of staff understood the on president !	NG
a floor ate a floor on every president .	GR
delicious chief of staff wanted a pickled pickle !	NG
the president in the fine president the a sandwich understood a sandwich !	NG
the chief of staff under the perplexed pickle under the chief of staff ate the delicious pickled floor under the fine floor .	GR
is it true that a sandwich in kissed president in a pickle understood a sandwich ?	NG
a fine president on a pickled perplexed chief of staff kissed the floor !	GR
the delicious pickle under the sandwich in pickled floor understood a pickled floor .	NG
the floor understood a floor with the fine floor in a pickle .	GR
understood chief of staff understood a chief of staff .	NG
is it true that the floor in the delicious delicious chief of staff kissed a pickled chief of staff ?	GR
a pickled president on a floor with every chief of staff fine a sandwich understood every president !	NG
a fine pickle pickled perplexed floor in a sandwich in the pickle under a president .	NG
a delicious the president wanted the chief of staff !	NG
a perplexed fine floor the a president !	NG
fine president in the sandwich pickled a floor !	NG
is it true that the perplexed pickle kissed the perplexed president ?	GR
the delicious pickle ate every floor in the delicious fine pickled president .	GR
is it true that the chief of staff pickled a pickled fine pickled sandwich in a sandwich on a floor with a perplexed floor in perplexed sandwich under every floor under the floor ?	NG
a pickle in a floor delicious a delicious chief of staff with the chief of staff on every president .	NG
is it true that a perplexed president wanted the president with a chief of staff ?	GR
the pickled sandwich wanted every president .	GR
is it true that the floor under every pickle wanted every delicious perplexed pickle ?	GR
every sandwich ate under president !	NG
is it true that every pickled sandwich understood the perplexed president under the delicious perplexed delicious sandwich ?	GR
is it true that the president ate every chief of staff ?	GR
the chief of staff in the perplexed president on a fine president wanted the pickle on a pickle with the floor .	GR
under pickled delicious sandwich understood every pickle on the chief of staff !	NG
every president wanted a pickle under the pickle !	GR
a pickle kissed understood president .	NG
every delicious perplexed president pickled perplexed president with the perplexed president .	NG
a sandwich pickled fine pickle !	NG
a sandwich ate every delicious president !	GR
a floor understood pickled pickled pickled delicious delicious delicious sandwich !	NG
is it true that the chief of staff with the floor under every chief of staff ate a president ?	GR
is it true that a president ate the sandwich ?	GR
the chief of staff with the delicious floor wanted a pickle .	GR
is it true that the chief of staff understood a fine pickle ?	GR
is it true that a president fine a perplexed perplexed fine pickle understood every delicious chief of staff ?	NG
a sandwich pickled the on floor .	NG
is it true that a sandwich understood the pickle ?	GR
is it true that a pickle understood kissed chief of staff ?	NG
is it true that every sandwich pickled a chief of staff ?	GR
is it true that the perplexed floor ate a president under a sandwich ?	GR
a sandwich kissed the the delicious pickle !	NG
the floor ate understood chief of staff in the perplexed perplexed president under the floor .	NG
is it true that a sandwich delicious a perplexed delicious sandwich ?	NG
a president on every perplexed floor in the floor under every perplexed floor a a fine fine delicious pickle in a pickle .	NG
every ate floor understood a pickled pickle under every delicious chief of staff !	NG
is it true that the pickle on the president ?	NG
is it true that a delicious pickle ate under president ?	NG
the perplexed perplexed pickled fine floor under a chief of staff in the chief of staff in a pickled perplexed perplexed president with the perplexed sandwich under the floor under the sandwich pickled every floor on the sandwich !	GR
the perplexed floor wanted a with delicious president .	NG
a chief of staff kissed the president in the sandwich !	GR
a perplexed delicious sandwich in a floor !	NG
the pickled floor wanted a pickled sandwich .	GR
a sandwich ate the the delicious floor .	NG
is it true that a sandwich understood every sandwich ?	GR
a pickled pickle in the sandwich on a perplexed chief of staff with the chief of staff in a president with the chief of staff understood the pickled president .	GR
a floor in a chief of staff with a pickled pickled floor under a chief of staff wanted the pickle !	GR
in floor pickled a chief of staff .	NG
is it true that a president kissed a sandwich ?	GR
the delicious understood floor pickled a pickle in the floor .	NG
is it true that the perplexed pickled floor ate the chief of staff ?	GR
the pickled delicious sandwich wanted a sandwich !	GR
is it true that the sandwich kissed a president on every delicious chief of staff with every pickled perplexed sandwich ?	GR
ate pickle ate a chief of staff .	NG
a sandwich pickled a president .	GR
is it true that a fine president pickled the delicious president ?	GR
is it true that the perplexed president in the floor in a fine chief of staff understood the floor in the perplexed chief of staff with a floor ?	GR
is it true that the floor with the chief of staff pickled every perplexed fine under delicious pickled fine president ?	NG
pickled floor wanted a sandwich with the president in a pickled chief of staff !	NG
is it true that the president pickled the sandwich ?	GR
a floor understood the floor wanted a delicious president !	NG
is it true that a president understood every perplexed floor under the sandwich ?	GR
