is it true that the pickle in the fine perplexed pickle with a floor on every pickle understood a every delicious sandwich on every sandwich in the pickled president ?	NG
the perplexed in floor wanted the floor .	NG
the chief of staff ate the sandwich .	GR
every delicious sandwich on a perplexed pickle ate a perplexed pickle !	GR
is it true that a sandwich wanted understood floor ?	NG
a chief of staff kissed wanted pickle .	NG
the president kissed the chief of staff under a floor .	GR
every president wanted delicious pickle !	NG
the president with the president pickled a pickled fine president kissed the fine pickle !	NG
is it true that the pickle under a floor on the fine floor kissed pickled pickle ?	NG
is it true that the pickled floor on the chief of staff kissed the president under the delicious floor with the fine delicious president ?	GR
the chief of staff wanted every pickled perplexed chief of staff under a delicious president !	GR
a president in a president !	NG
a fine pickle ate a floor !	GR
fine pickle wanted the pickle .	NG
pickled sandwich ate a president .	NG
is it true that a delicious chief of staff ate the pickled pickled delicious perplexed floor in under sandwich with every chief of staff on the floor ?	NG
the floor wanted pickled fine pickled president .	NG
a floor pickled understood president .	NG
every chief of staff kissed a pickled floor understood the pickle !	NG
is it true that wanted pickle kissed the pickled chief of staff ?	NG
the chief of staff kissed a delicious pickle !	GR
is it true that the fine pickle understood the sandwich with pickled pickled fine pickle ?	NG
is it true that the fine sandwich ate pickled pickle ?	NG
is it true that a pickled sandwich kissed the chief of staff with the fine president ?	GR
a fine chief of staff kissed a sandwich .	GR
the floor under a floor with a perplexed floor !	NG
is it true that a delicious pickle pickled a pickle ?	GR
the floor wanted every president !	GR
a the pickled delicious fine president in the pickle ate the pickle !	NG
the president pickled every pickled floor !	GR
fine president understood every president !	NG
every fine president kissed wanted president in a president in the floor .	NG
every pickle pickled the president .	GR
the understood pickled floor ate a chief of staff .	NG
a pickled sandwich understood the floor with the president .	GR
the delicious perplexed chief of staff kissed a president !	GR
is it true that a sandwich kissed the pickled delicious sandwich in the fine chief of staff ?	GR
the pickle on every floor pickled a sandwich in a pickle !	GR
is it true that the perplexed sandwich understood a sandwich ?	GR
ate president ate a president .	NG
a perplexed floor wanted the sandwich !	GR
a delicious floor kissed a delicious sandwich !	GR
is it true that every sandwich the every pickle ?	NG
the chief of staff fine a chief of staff wanted a floor .	NG
the sandwich fine a perplexed president .	NG
the chief of staff wanted the wanted sandwich on a perplexed pickled floor !	NG
the president a every delicious sandwich !	NG
is it true that ate floor kissed a fine president ?	NG
is it true that ate floor ate a chief of staff ?	NG
is it true that a president wanted a pickled chief of staff ?	GR
is it true that a fine floor on the pickle understood a sandwich in every pickle in a under pickle ?	NG
is it true that the pickled sandwich with the pickled president ate pickled delicious chief of staff ?	NG
is it true that a president delicious every perplexed pickle pickled every floor ?	NG
a floor in a president under a sandwich with a pickle in the sandwich understood a pickle !	GR
is it true that the pickle kissed the pickle ?	GR
the president kissed a sandwich .	GR
is it true that a fine sandwich kissed the pickled pickle ?	GR
is it true that the floor with the in pickle pickled a pickled pickled floor ?	NG
is it true that every chief of staff pickled a delicious chief of staff on the delicious pickled pickled president ?	GR
is it true that every floor kissed a fine pickled president ?	GR
is it true that the sandwich wanted the understood pickle ?	NG
a pickle kissed a pickle in a perplexed sandwich !	GR
a pickled chief of staff delicious the chief of staff in the president under a sandwich on the president .	NG
is it true that a pickle ate every delicious sandwich in on pickle ?	NG
is it true that the president with a sandwich wanted the pickled perplexed floor with a on sandwich under a delicious pickled fine pickled pickled delicious sandwich ?	NG
a chief of staff with a pickled pickle in a sandwich ate the floor !	GR
every perplexed pickled chief of staff under a pickled delicious sandwich !	NG
a sandwich with the sandwich the a pickled fine fine perplexed floor .	NG
the chief of staff fine a chief of staff !	NG
the chief of staff understood the floor in the chief of staff .	GR
the floor wanted the a pickle !	NG
a pickle kissed a chief of staff with a floor .	GR
the chief of staff understood a the pickled fine president !	NG
a perplexed fine floor the a president .	NG
the chief of staff pickled delicious pickled sandwich !	NG
is it true that a pickled pickle kissed in president with a pickle ?	NG
a sandwich with fine pickled pickle understood a sandwich !	NG
is it true that the pickle under kissed pickle kissed the perplexed sandwich ?	NG
a fine pickled perplexed president on the pickle in the president .	NG
the the pickle kissed a sandwich .	NG
a sandwich understood every pickled floor a the floor in a chief of staff .	NG
is it true that a president understood a pickle ?	GR
a pickle under the perplexed president in a fine fine perplexed floor pickled a perplexed fine delicious chief of staff !	GR
a president kissed every perplexed president !	GR
is it true that the perplexed chief of staff wanted a sandwich ?	GR
the sandwich kissed the fine a pickled floor !	NG
is it true that every sandwich kissed fine chief of staff ?	NG
every perplexed sandwich every a chief of staff !	NG
is it true that a pickled chief of staff understood a perplexed president ?	GR
is it true that a pickle pickled a floor with the perplexed delicious chief of staff under the delicious floor ?	GR
the sandwich ate every perplexed chief of staff !	GR
is it true that every president under the president pickled the pickle ?	GR
is it true that kissed pickle pickled the chief of staff ?	NG
a floor understood the chief of staff .	GR
in sandwich pickled a pickle !	NG
is it true that a sandwich kissed pickled chief of staff ?	NG
is it true that every chief of staff in a president under a perplexed pickled sandwich kissed the fine fine pickle under the chief of staff ?	GR
a pickled sandwich on the sandwich in a fine pickled chief of staff in a pickled sandwich in every fine delicious fine president in a pickle kissed the sandwich .	GR
is it true that a president ate a sandwich ?	GR
is it true that the pickle pickled a floor in a floor ?	GR
is it true that the fine pickled floor under every fine sandwich ate a sandwich in the floor ?	GR
is it true that the president pickled the pickle ?	GR
is it true that the chief of staff pickled a chief of staff ?	GR
a chief of staff understood on fine perplexed sandwich .	NG
the floor wanted the floor in wanted perplexed chief of staff !	NG
the sandwich pickled in pickle !	NG
every sandwich ate a on sandwich .	NG
a pickle delicious a pickle kissed the chief of staff .	NG
is it true that a president kissed every floor ?	GR
a perplexed sandwich under the president wanted every perplexed floor !	GR
is it true that the sandwich wanted every pickle in the chief of staff ?	GR
a president in the pickled perplexed president pickled every delicious the floor !	NG
a delicious chief of staff pickled the sandwich on a chief of staff with a chief of staff in a sandwich !	GR
every delicious delicious pickle ate fine fine delicious perplexed floor .	NG
the delicious president ate every sandwich .	GR
is it true that the sandwich understood every fine delicious floor ?	GR
a fine pickled perplexed sandwich pickled the sandwich under the pickle with a pickled delicious pickled a fine president .	NG
is it true that fine floor on a pickle on a chief of staff ate every pickled president ?	NG
the perplexed president understood the pickled chief of staff in a delicious chief of staff on the chief of staff .	GR
is it true that every pickled chief of staff wanted delicious sandwich ?	NG
is it true that a pickled floor with wanted perplexed president ate the fine president ?	NG
every in delicious pickle wanted a perplexed fine chief of staff .	NG
every floor kissed perplexed chief of staff !	NG
a pickled floor under every floor !	NG
the pickle in the sandwich wanted a pickle in a perplexed pickled floor in in chief of staff under the president under a floor with the fine sandwich under a fine perplexed president on every president on the sandwich with the fine pickled perplexed pickled pickled chief of staff .	NG
a fine president under a fine sandwich pickled a president !	GR
a chief of staff on a president under the pickled sandwich in a president with the delicious pickled chief of staff ate the perplexed sandwich in a sandwich in a floor under a floor with a fine president under every president in a president in a delicious pickled fine floor with a sandwich in a floor on a president on every president under a president under a president with the perplexed pickled perplexed perplexed chief of staff on a floor !	GR
is it true that a chief of staff in the sandwich under a perplexed president wanted a pickled president ?	GR
a president understood a president !	GR
understood delicious pickled fine chief of staff understood every chief of staff .	NG
the chief of staff with the president .	NG
a perplexed pickled ate pickle in a pickle ate a pickled delicious sandwich on every sandwich with the floor with a floor on the chief of staff !	NG
every fine sandwich on every president wanted the pickle .	GR
a pickle with a fine pickled pickle under the sandwich under a floor with the sandwich with a delicious president with the sandwich kissed the president .	GR
every fine pickle under the floor under the sandwich on the chief of staff with every pickled president on a pickle in the chief of staff ate a president .	GR
is it true that the floor under a pickle ?	NG
every perplexed delicious chief of staff understood a president .	GR
is it true that the under floor kissed a fine sandwich with a president ?	NG
is it true that a perplexed president wanted the pickle ?	GR
every president pickled perplexed delicious pickle under a floor !	NG
is it true that every chief of staff understood the president ?	GR
is it true that every pickled sandwich in perplexed president kissed every pickle ?	NG
the floor pickled the floor delicious the floor .	NG
fine fine president understood a president in a president !	NG
every chief of staff pickled the perplexed pickle .	GR
the perplexed fine pickle wanted pickled fine floor !	NG
a wanted pickle ate a pickle !	NG
is it true that the floor wanted the pickle ?	GR
every chief of staff understood the floor !	GR
a pickle kissed the delicious sandwich .	GR
is it true that a floor kissed the perplexed pickled pickled president ?	GR
the floor with a sandwich ate the president ate a delicious sandwich !	NG
the president understood every president !	GR
kissed perplexed fine pickled chief of staff with the sandwich kissed the chief of staff !	NG
is it true that the sandwich wanted a fine president with the fine sandwich ?	GR
a perplexed with chief of staff pickled a pickle .	NG
the perplexed fine pickle on pickled president kissed every president !	NG
is it true that the floor wanted every pickled floor ?	GR
is it true that a fine pickled delicious sandwich fine the delicious chief of staff ?	NG
is it true that a pickled chief of staff under the president in a chief of staff on a president with a pickled chief of staff wanted a fine sandwich ?	GR
is it true that the chief of staff understood a floor ?	GR
the pickled floor on a delicious delicious delicious chief of staff understood the pickle !	GR
is it true that a president with a chief of staff with the fine delicious pickle understood a president ?	GR
is it true that the perplexed fine delicious president understood a chief of staff ?	GR
a floor the a pickle .	NG
the floor kissed a floor .	GR
a floor in a pickle pickled the pickled floor under a sandwich .	GR
is it true that a floor with the sandwich kissed the pickled fine perplexed floor ?	GR
the sandwich with the chief of staff with the sandwich with every floor understood a perplexed kissed president on the delicious pickle !	NG
the president pickled the delicious pickle with a pickled perplexed pickle .	GR
a pickle kissed the sandwich .	GR
a president wanted a perplexed perplexed pickle on the pickle under a sandwich on the delicious chief of staff .	GR
is it true that a pickle kissed the floor on the pickle ?	GR
a in floor kissed the sandwich !	NG
is it true that a president pickled the chief of staff on every every delicious pickle with a sandwich with a floor ?	NG
a chief of staff pickled every sandwich on the president under the delicious sandwich !	GR
the pickled president wanted the sandwich !	GR
is it true that a chief of staff wanted with pickled fine sandwich ?	NG
every pickle in the chief of staff .	NG
the chief of staff under every pickle kissed pickled floor !	NG
a pickle understood with fine sandwich .	NG
is it true that a pickled pickled chief of staff pickled the pickle ?	GR
every president under every pickle ate a pickled chief of staff !	GR
a president fine the perplexed fine sandwich !	NG
the delicious president understood a pickled sandwich !	GR
a delicious delicious president pickled the chief of staff .	GR
is it true that a in pickle kissed a fine chief of staff ?	NG
a chief of staff understood a chief of staff in the perplexed chief of staff on every president .	GR
the president delicious the chief of staff !	NG
the pickled fine president fine a chief of staff !	NG
a president a the delicious chief of staff .	NG
a perplexed sandwich ate a pickled pickle !	GR
a pickle kissed a pickle .	GR
the sandwich in the pickle with the pickled pickle delicious the fine perplexed sandwich !	NG
every pickle pickled perplexed delicious sandwich !	NG
the president ate a president .	GR
the delicious chief of staff understood the perplexed fine fine delicious sandwich under a president .	GR
the pickle ate the president !	GR
the pickle a a sandwich .	NG
a president a a delicious pickle under the perplexed floor .	NG
the pickled chief of staff kissed the pickle .	GR
is it true that the sandwich kissed the fine delicious delicious fine sandwich ?	GR
a floor with a floor ate pickled pickle .	NG
a pickle wanted under chief of staff under a pickle !	NG
every floor wanted a delicious floor under the pickle .	GR
the wanted chief of staff wanted a pickled floor !	NG
the floor kissed a pickled floor !	GR
a sandwich kissed the the chief of staff .	NG
is it true that the president kissed the pickled perplexed pickle ?	GR
ate fine chief of staff wanted the floor !	NG
a pickled perplexed fine floor kissed a president with a sandwich .	GR
is it true that a pickled floor pickled every sandwich ?	GR
the delicious floor wanted the the perplexed chief of staff .	NG
a pickled fine floor understood the perplexed pickled chief of staff !	GR
is it true that a delicious ate fine fine fine floor ate the chief of staff ?	NG
is it true that the chief of staff ate a president ?	GR
is it true that the pickled chief of staff a the delicious pickled pickled president ?	NG
is it true that with chief of staff understood a perplexed delicious president ?	NG
a perplexed sandwich ate the pickle .	GR
a sandwich kissed a delicious perplexed pickle .	GR
the president kissed the floor !	GR
is it true that the delicious president understood a floor ?	GR
on fine sandwich ate a chief of staff in the floor under every sandwich in a sandwich !	NG
is it true that a chief of staff with the sandwich with a chief of staff pickled the sandwich on a president on every pickled perplexed president with every sandwich on a pickled fine chief of staff with the fine fine president on a pickled delicious perplexed sandwich under the a president ?	NG
every sandwich with a delicious pickle with a fine chief of staff on a chief of staff in the floor ate every perplexed pickled pickled pickled sandwich under every chief of staff .	GR
is it true that the president pickled a pickle with a pickle on the sandwich ?	GR
a sandwich the a pickle !	NG
a floor with a floor under a delicious perplexed perplexed delicious pickle in a pickle under a sandwich understood a pickled pickled perplexed floor .	GR
is it true that delicious perplexed delicious pickled president pickled the president ?	NG
is it true that the pickled floor wanted every wanted sandwich ?	NG
is it true that a pickle pickled a floor on every pickle ?	GR
a chief of staff on the floor on the chief of staff wanted perplexed perplexed pickle !	NG
the pickle pickled the pickle .	GR
is it true that the chief of staff kissed the sandwich ?	GR
the pickle kissed the pickle .	GR
every floor in the president in a chief of staff under a pickled pickled delicious chief of staff understood the perplexed perplexed president .	GR
the kissed chief of staff kissed the floor under the perplexed perplexed sandwich !	NG
is it true that every pickled delicious perplexed chief of staff wanted the floor ?	GR
every floor wanted a president on a pickled pickled floor on a pickle every the sandwich on a sandwich on the delicious president !	NG
a floor understood a pickled in pickle !	NG
is it true that a floor pickled every fine chief of staff ?	GR
on pickle pickled every president !	NG
a president every a floor with a president .	NG
a fine perplexed sandwich in a delicious chief of staff kissed the floor .	GR
every a chief of staff understood the perplexed sandwich !	NG
a sandwich in in floor understood the president !	NG
is it true that the perplexed sandwich in a sandwich fine a pickle ?	NG
the sandwich ate a perplexed president .	GR
a chief of staff understood a president a every floor !	NG
a pickle ate the delicious pickle in a fine delicious chief of staff !	GR
the pickled ate perplexed chief of staff wanted the president on the president !	NG
is it true that every president on under pickle pickled a pickle on a pickle ?	NG
the floor kissed with perplexed pickle !	NG
is it true that a floor on a president kissed a pickled floor ?	GR
a pickle kissed the fine perplexed perplexed delicious perplexed fine chief of staff under every sandwich with a perplexed floor in the president .	GR
ate delicious fine floor ate every president !	NG
a sandwich in a perplexed pickle ate ate sandwich !	NG
is it true that the floor kissed a pickled delicious pickled president ?	GR
every sandwich wanted a floor !	GR
the floor wanted a president in the delicious president !	GR
the sandwich understood delicious chief of staff .	NG
is it true that the perplexed delicious delicious chief of staff pickled the floor under the president ?	GR
is it true that every floor understood a chief of staff ?	GR
is it true that fine sandwich kissed a pickle ?	NG
every chief of staff under in fine perplexed delicious fine president understood the floor in the perplexed pickle !	NG
is it true that the fine pickled perplexed floor wanted the sandwich ?	GR
every pickle understood a president with the chief of staff !	GR
is it true that a perplexed chief of staff pickled every chief of staff ?	GR
the fine president pickled a perplexed perplexed sandwich .	GR
every pickled floor in every president with the sandwich ate in chief of staff !	NG
is it true that the delicious fine pickle with every perplexed pickle wanted every pickled chief of staff ?	GR
the delicious fine pickle understood the president in the chief of staff in a pickle !	GR
on delicious chief of staff ate a sandwich !	NG
a chief of staff kissed a pickle .	GR
the sandwich fine a sandwich !	NG
every floor understood on floor under the floor !	NG
the fine sandwich under a pickle understood the perplexed pickled president !	GR
a president pickled delicious sandwich !	NG
a chief of staff with a president under a floor wanted the fine fine chief of staff .	GR
with president on a president ate a chief of staff .	NG
is it true that a delicious perplexed sandwich ate a pickle ?	GR
the fine delicious pickle under every delicious pickled fine sandwich wanted the sandwich under a fine sandwich in every sandwich in the president !	GR
a delicious pickle pickled on pickled floor !	NG
the pickled delicious pickle understood the fine delicious perplexed sandwich .	GR
the sandwich the a floor in a sandwich !	NG
is it true that a delicious pickled pickle understood a fine pickle ?	GR
a pickled pickled floor understood pickled president .	NG
a chief of staff every a pickle !	NG
a fine delicious pickled floor understood a president !	GR
the sandwich wanted a floor in a pickle !	GR
the president on a delicious pickle wanted the floor on every pickle .	GR
a floor ate every on pickle .	NG
every every pickled fine pickle pickled the pickled pickle on the president under the president !	NG
is it true that a chief of staff pickled a floor ?	GR
is it true that a with floor kissed the president ?	NG
every delicious delicious floor wanted the delicious perplexed pickled floor .	GR
the fine fine pickle pickled a president !	GR
every delicious sandwich wanted a fine fine fine sandwich .	GR
every floor perplexed a sandwich .	NG
is it true that every floor on the chief of staff in the president understood the president ?	GR
a pickled under delicious floor ate every sandwich .	NG
a delicious fine fine delicious pickled under chief of staff ate a fine floor !	NG
every pickle on a floor !	NG
wanted fine fine perplexed pickled sandwich on a perplexed sandwich ate the president !	NG
a delicious chief of staff pickled the pickle !	GR
is it true that a sandwich on the pickled pickled pickle on a floor in every perplexed floor under the floor on the fine president in a delicious floor pickled every president ?	GR
is it true that the perplexed delicious floor on the fine pickled president on the president under every pickled chief of staff on a delicious perplexed chief of staff pickled a floor ?	GR
the fine pickle ate the floor .	GR
is it true that a wanted chief of staff wanted a pickled perplexed pickle ?	NG
is it true that under pickle pickled a president on a floor ?	NG
the delicious president wanted a chief of staff with a chief of staff in pickled sandwich .	NG
a pickled chief of staff kissed every sandwich .	GR
a pickle kissed a fine chief of staff with a floor .	GR
is it true that the pickle kissed the sandwich on the pickle under the fine delicious chief of staff ?	GR
the president understood the president .	GR
a perplexed delicious president ate every perplexed perplexed pickled pickle .	GR
the president understood a fine president under every chief of staff .	GR
a pickle kissed the pickle !	GR
a chief of staff kissed under pickled delicious perplexed pickle .	NG
a pickled chief of staff ate the perplexed fine fine president with every sandwich .	GR
ate sandwich pickled a pickle .	NG
in floor in every president under a chief of staff in the pickle in the sandwich on the floor ate a sandwich .	NG
is it true that a floor ate every pickle ?	GR
a pickled fine perplexed sandwich pickled the floor .	GR
is it true that a president pickled every president ?	GR
is it true that the chief of staff ate pickled delicious sandwich ?	NG
the floor pickled the with delicious floor in a delicious pickle !	NG
a pickled fine sandwich understood the sandwich .	GR
a delicious pickle on the floor under the delicious pickled sandwich under a delicious pickled chief of staff with a perplexed fine sandwich with the perplexed fine fine floor with the sandwich under a pickle under the floor under every pickle under the perplexed floor in a floor with a pickle the a pickle !	NG
is it true that the pickle pickled every ate chief of staff under the sandwich ?	NG
a president wanted the floor !	GR
is it true that a pickle wanted wanted floor ?	NG
the pickled delicious sandwich with pickled floor ate every pickled president .	NG
is it true that a president understood a sandwich on a in pickled sandwich in the pickle ?	NG
a chief of staff pickled a floor !	GR
the chief of staff kissed fine perplexed perplexed president !	NG
the pickle with the pickled floor under a pickled delicious pickle with a floor !	NG
the pickled pickle understood the sandwich in the delicious pickled sandwich under a pickle .	GR
is it true that a chief of staff on a sandwich ?	NG
is it true that under fine delicious floor in the sandwich on the president with the floor in the perplexed floor pickled the president ?	NG
is it true that the pickled delicious fine delicious fine pickled pickle pickled a president ?	GR
a sandwich understood ate pickle on every pickled chief of staff .	NG
is it true that the fine pickle understood the president ?	GR
a floor on the perplexed chief of staff on the perplexed the president understood a fine delicious pickled fine chief of staff .	NG
the pickle fine every pickle .	NG
the perplexed floor in the president pickled a floor .	GR
a president kissed in pickle !	NG
a perplexed delicious delicious pickle ate a chief of staff !	GR
the president kissed a chief of staff with the perplexed delicious floor !	GR
is it true that a delicious perplexed fine president wanted the floor in the pickle ?	GR
the president under every floor understood the fine perplexed chief of staff under under pickled pickle !	NG
every floor wanted a floor .	GR
a sandwich understood a delicious floor under a pickled chief of staff .	GR
is it true that the pickle ate on floor ?	NG
is it true that a chief of staff ate a chief of staff ?	GR
every floor with a fine president in a president ate the understood sandwich !	NG
is it true that a fine sandwich pickled the fine sandwich with perplexed fine chief of staff ?	NG
is it true that the floor pickled a sandwich under every fine sandwich ?	GR
a pickle pickled the perplexed delicious perplexed sandwich in a chief of staff !	GR
a sandwich wanted a pickled chief of staff .	GR
every perplexed pickled sandwich pickled the floor a the pickle .	NG
the pickled sandwich in a pickled perplexed pickled perplexed president on the sandwich in a floor in the floor with the perplexed perplexed chief of staff pickled the chief of staff in a president wanted the president under a pickled perplexed president .	NG
every chief of staff wanted a with president .	NG
on pickle pickled the fine perplexed floor .	NG
a pickled pickle with with floor on a pickled delicious sandwich understood the chief of staff .	NG
a president ate every president .	GR
the chief of staff understood a pickled sandwich !	GR
a chief of staff kissed the on president .	NG
the fine chief of staff the the floor .	NG
is it true that the chief of staff wanted a fine president under every president with a president ?	GR
the pickled sandwich kissed the pickled floor with the delicious floor under the president on a pickled pickle !	GR
a pickle with every sandwich with every chief of staff on the president wanted the floor !	GR
is it true that a pickled floor with the delicious perplexed chief of staff under a sandwich in a pickled delicious fine president fine the fine chief of staff with a pickle in the floor understood a president ?	NG
is it true that the sandwich delicious a sandwich wanted a floor ?	NG
is it true that a sandwich wanted the floor ?	GR
the pickle wanted with floor .	NG
is it true that a fine pickle in a pickle kissed the floor ?	GR
is it true that a sandwich wanted a pickled floor under the floor on the ate pickle ?	NG
a pickled fine sandwich wanted the delicious pickle with a chief of staff with the pickled sandwich !	GR
a chief of staff understood a chief of staff on the chief of staff the a delicious perplexed sandwich !	NG
a perplexed sandwich fine every sandwich !	NG
is it true that a pickled fine delicious chief of staff wanted the chief of staff ?	GR
a perplexed floor pickled the fine sandwich .	GR
is it true that on sandwich in the pickle wanted the president ?	NG
is it true that every sandwich wanted a pickle ?	GR
every fine chief of staff understood a sandwich !	GR
is it true that a pickled perplexed fine fine pickled president kissed a chief of staff on a perplexed delicious pickle with a president with a delicious floor ?	GR
a sandwich under every pickled floor on the chief of staff pickled a sandwich .	GR
the floor pickled a perplexed pickled floor with every delicious president under the chief of staff on every understood sandwich in the pickled chief of staff !	NG
the a pickle pickled every pickle !	NG
is it true that a chief of staff under every delicious pickled chief of staff with a floor ?	NG
is it true that a perplexed the chief of staff wanted a perplexed sandwich ?	NG
a pickle understood the in delicious delicious pickled pickled pickle .	NG
the pickle under the perplexed president under every floor wanted the pickled pickle !	GR
is it true that the pickle perplexed the chief of staff ?	NG
is it true that the fine fine sandwich pickled the kissed pickled fine sandwich ?	NG
is it true that the president kissed every chief of staff ?	GR
the floor understood a delicious floor .	GR
a perplexed floor kissed delicious perplexed floor .	NG
the fine pickle ate pickled chief of staff .	NG
the perplexed pickle kissed the perplexed pickle !	GR
is it true that a chief of staff pickled the president with ate sandwich ?	NG
a pickled perplexed chief of staff with understood floor pickled the pickled pickled chief of staff .	NG
a president every a perplexed chief of staff in the delicious president ate the delicious delicious delicious sandwich .	NG
is it true that every pickle understood the floor ?	GR
the pickle pickled the delicious pickle understood a sandwich in the president !	NG
is it true that the pickle in the pickled fine pickle under a pickle in the sandwich on a delicious floor ate the pickled pickled pickled sandwich ?	GR
every delicious delicious sandwich in with floor kissed a pickle !	NG
pickled pickle wanted a sandwich !	NG
a pickled president the the chief of staff !	NG
a delicious pickled president pickled the pickle .	GR
every fine delicious chief of staff fine every floor !	NG
a chief of staff understood the pickled perplexed pickle .	GR
is it true that a president pickled the floor ?	GR
in pickled perplexed chief of staff ate every pickle .	NG
a sandwich on a president .	NG
the sandwich wanted the pickle .	GR
on perplexed perplexed delicious floor ate every floor .	NG
pickled president wanted the delicious pickled delicious pickle !	NG
is it true that a fine chief of staff pickled a floor ?	GR
is it true that the floor understood the floor on a chief of staff ?	GR
the fine delicious chief of staff wanted a president !	GR
a sandwich the a pickle under the delicious president .	NG
the delicious floor understood a chief of staff .	GR
the sandwich kissed in president .	NG
is it true that a pickle under the sandwich ate under delicious perplexed pickled sandwich ?	NG
a floor ate the president !	GR
a pickled president understood the chief of staff in every president .	GR
the chief of staff a a perplexed chief of staff !	NG
the pickled pickle wanted a perplexed sandwich with the chief of staff with a perplexed sandwich .	GR
a pickle ate delicious pickle !	NG
a delicious pickled president ate a sandwich with a pickle in the sandwich .	GR
the floor ate the president !	GR
the president under the sandwich in a sandwich .	NG
is it true that under president wanted a floor in a pickled pickled fine pickled sandwich with a sandwich under the perplexed fine president ?	NG
is it true that the perplexed president kissed every the pickle under a perplexed delicious president ?	NG
a floor wanted the a chief of staff under the pickle .	NG
the chief of staff under a floor under the fine delicious pickled chief of staff ate a floor .	GR
a pickle understood perplexed sandwich .	NG
is it true that the president wanted the perplexed understood sandwich ?	NG
is it true that every sandwich ate the perplexed floor with a sandwich ?	GR
is it true that a a pickle in the sandwich in every perplexed chief of staff wanted a delicious fine delicious sandwich ?	NG
is it true that a president on a delicious perplexed president understood the president ?	GR
a chief of staff understood every perplexed president .	GR
is it true that the perplexed president in a floor under the delicious pickle understood the pickle under the perplexed president ?	GR
a floor with the perplexed chief of staff in every floor ate a fine chief of staff with a pickle on pickled floor under the sandwich with the sandwich in the sandwich on the president with a perplexed president !	NG
every president ate the perplexed chief of staff .	GR
is it true that a sandwich kissed with fine chief of staff ?	NG
is it true that the delicious fine floor wanted the president ?	GR
is it true that a floor a a delicious pickle under the perplexed pickle kissed the delicious floor ?	NG
a a delicious floor pickled every pickle .	NG
a floor a the perplexed sandwich .	NG
is it true that the floor pickled every pickle ?	GR
a perplexed delicious perplexed president on the delicious floor pickled the president .	GR
the president ate the chief of staff with the chief of staff under the chief of staff .	GR
is it true that the president under a chief of staff pickled a pickle ?	GR
the floor with a pickle understood the fine president under a president .	GR
is it true that the sandwich under a chief of staff ate pickled floor ?	NG
a delicious pickle pickled a sandwich perplexed a floor !	NG
is it true that a perplexed chief of staff under a pickle ?	NG
is it true that every floor under a delicious chief of staff ?	NG
understood delicious floor pickled the pickle .	NG
a delicious pickle with the pickled perplexed chief of staff wanted a president with the pickled delicious pickled pickle under the perplexed delicious chief of staff on every sandwich with a pickle !	GR
is it true that under president understood the pickle ?	NG
is it true that a pickled perplexed president ate the floor ?	GR
understood pickled floor wanted the chief of staff !	NG
a fine pickle pickled a delicious perplexed chief of staff under a sandwich !	GR
the pickle ate a pickled chief of staff .	GR
kissed chief of staff in the sandwich wanted a sandwich !	NG
is it true that every delicious pickled president wanted the sandwich under the pickle ?	GR
is it true that a pickled pickled sandwich understood the president ?	GR
a sandwich pickled a pickled sandwich !	GR
a perplexed president under a pickled president the the fine pickled pickled chief of staff understood the sandwich .	NG
the chief of staff pickled a chief of staff under a chief of staff under the perplexed floor under pickled sandwich on the delicious chief of staff .	NG
the perplexed floor kissed the chief of staff .	GR
the pickle with a pickle on the chief of staff kissed the perplexed fine pickled sandwich in every president with a delicious delicious pickle .	GR
is it true that a pickled pickled perplexed pickle pickled a chief of staff ?	GR
a pickled sandwich kissed a floor in the president .	GR
the sandwich kissed a chief of staff !	GR
every chief of staff on pickled delicious sandwich wanted the sandwich .	NG
with floor pickled the president !	NG
ate president pickled the chief of staff under a president .	NG
a fine chief of staff understood a president !	GR
delicious chief of staff ate a fine president .	NG
is it true that a fine chief of staff delicious the perplexed pickle understood a sandwich ?	NG
is it true that every fine perplexed pickle under the chief of staff under the pickle with the president pickled a sandwich ?	GR
is it true that a president on a chief of staff ate a chief of staff ?	GR
the president under a president understood a floor in a pickle under the pickle fine a sandwich with the sandwich under every perplexed fine delicious sandwich under a fine fine president under a chief of staff under a pickle under the president .	NG
a fine pickle in the sandwich on a fine president kissed a fine sandwich under a chief of staff .	GR
a floor understood a president !	GR
the president wanted the president !	GR
is it true that a pickle understood under sandwich ?	NG
pickled pickled chief of staff kissed the sandwich !	NG
kissed floor kissed every sandwich !	NG
is it true that perplexed pickled pickle ate a floor ?	NG
the floor pickled with fine pickle .	NG
ate pickled president wanted the pickled president !	NG
the delicious chief of staff wanted a delicious delicious chief of staff kissed a president !	NG
a sandwich on every chief of staff ate the ate floor !	NG
a president kissed perplexed perplexed chief of staff .	NG
a president under the chief of staff with the delicious fine pickled perplexed pickled floor on a floor kissed pickled sandwich .	NG
is it true that a president kissed the pickle ?	GR
the chief of staff understood every delicious perplexed delicious sandwich in the perplexed floor !	GR
in chief of staff wanted the sandwich !	NG
the president wanted understood pickled president !	NG
is it true that a pickle the a perplexed floor ?	NG
is it true that a perplexed pickle understood a president ?	GR
the pickle under the pickle wanted the pickle !	GR
a perplexed perplexed pickle ate a pickle with a sandwich in every sandwich in every perplexed chief of staff on the sandwich on a delicious pickle !	GR
the floor kissed the delicious chief of staff on a sandwich with the delicious fine president with perplexed sandwich .	NG
the floor kissed every pickle under every president with perplexed fine pickle in the pickled president under every delicious floor !	NG
is it true that a floor pickled the chief of staff ?	GR
a sandwich under the president understood a delicious president .	GR
the pickle kissed the floor .	GR
a pickle understood a fine pickle under a president .	GR
is it true that under chief of staff kissed the floor ?	NG
a floor understood a fine chief of staff with a floor under the pickle !	GR
the sandwich understood a fine delicious chief of staff with the pickle with the president !	GR
is it true that every president the a president ?	NG
the fine pickled fine perplexed fine floor on the delicious fine floor delicious the sandwich with every perplexed chief of staff under a delicious delicious chief of staff with the president pickled a chief of staff .	NG
a president pickled the president !	GR
a president in a chief of staff with a fine delicious floor the a sandwich pickled the perplexed perplexed pickled sandwich !	NG
the fine pickled pickle wanted a floor !	GR
the sandwich under the perplexed president understood every chief of staff .	GR
a floor on the floor wanted the sandwich with the president fine the perplexed floor !	NG
every delicious floor ate the floor !	GR
a pickle wanted pickled floor !	NG
a pickled sandwich under a pickle pickled the perplexed chief of staff !	GR
the fine delicious chief of staff ate the pickle in a pickled president on a fine delicious perplexed perplexed pickled president !	GR
is it true that the president pickled a delicious fine sandwich on every president with a sandwich on the floor with the president in a pickle in a pickled pickled president ?	GR
is it true that a chief of staff under a perplexed pickled chief of staff ate a sandwich ?	GR
the delicious floor with pickled pickled delicious floor wanted a floor under every sandwich in every fine chief of staff !	NG
a delicious president in a sandwich pickled a delicious sandwich under a fine sandwich in understood sandwich in the fine pickle .	NG
is it true that a delicious floor pickled the delicious sandwich ?	GR
the pickle the every floor pickled a president !	NG
every floor the the chief of staff .	NG
is it true that a pickled perplexed pickled pickle pickled a sandwich under a floor on a chief of staff ?	GR
on sandwich kissed the perplexed delicious sandwich !	NG
the pickled sandwich with every president on perplexed floor wanted every fine fine pickled pickle .	NG
a president in pickled delicious sandwich pickled the president .	NG
is it true that the chief of staff wanted the floor ?	GR
is it true that a sandwich with a pickle on the floor in a delicious pickle with a pickle in the pickle ?	NG
pickled pickle ate every perplexed pickle !	NG
the president wanted the sandwich on the pickle !	GR
a delicious pickled sandwich wanted a president under the sandwich in the fine chief of staff !	GR
a floor on a floor with the chief of staff !	NG
every president pickled the delicious chief of staff !	GR
ate pickled president wanted a pickle !	NG
every chief of staff pickled a perplexed sandwich !	GR
is it true that a chief of staff with a pickled president on the sandwich ?	NG
is it true that the floor wanted every floor ?	GR
on president in a fine pickle understood the chief of staff .	NG
the fine chief of staff understood a fine pickle with a chief of staff in a kissed delicious sandwich with the floor !	NG
is it true that the sandwich wanted the chief of staff ?	GR
is it true that the fine perplexed chief of staff delicious the president ?	NG
every ate president ate a fine perplexed perplexed pickle !	NG
a president understood a floor !	GR
a chief of staff ate the pickle !	GR
a floor under wanted floor wanted every delicious chief of staff !	NG
is it true that the perplexed perplexed perplexed chief of staff the a pickle ?	NG
the pickle under under pickle understood a perplexed perplexed floor !	NG
the sandwich pickled the chief of staff .	GR
is it true that the delicious perplexed perplexed perplexed chief of staff kissed delicious pickle ?	NG
the pickled sandwich with the with pickle understood every sandwich .	NG
is it true that on perplexed pickled delicious floor ate the floor under a sandwich in the fine floor in the floor ?	NG
is it true that the floor wanted a sandwich under the fine fine pickle in every fine sandwich ?	GR
the perplexed president ate the delicious floor understood a pickle .	NG
a sandwich in a pickled delicious chief of staff in a sandwich wanted the delicious chief of staff !	GR
the perplexed pickled chief of staff wanted understood pickle .	NG
a pickle kissed perplexed floor .	NG
is it true that a understood president understood a chief of staff ?	NG
the delicious floor wanted ate pickle with the chief of staff !	NG
every pickle understood a perplexed fine delicious floor !	GR
delicious sandwich wanted the perplexed president .	NG
a president ate the sandwich !	GR
is it true that a floor kissed the floor with the sandwich ?	GR
a chief of staff ate the pickled kissed floor in the chief of staff !	NG
is it true that a president with every floor wanted the fine chief of staff ?	GR
is it true that wanted floor kissed a fine pickled sandwich ?	NG
the sandwich ate a floor .	GR
the chief of staff pickled perplexed sandwich .	NG
is it true that a president perplexed a pickled sandwich under the pickled sandwich with the sandwich on a fine president ?	NG
every chief of staff pickled a perplexed sandwich .	GR
the floor kissed the president .	GR
fine floor ate a president on a pickled floor on a sandwich !	NG
is it true that a floor understood the understood floor with a perplexed sandwich ?	NG
a sandwich under a pickled pickle !	NG
is it true that a floor kissed the floor ?	GR
is it true that the delicious pickle the the pickled pickle ?	NG
the perplexed sandwich under wanted chief of staff ate the pickled perplexed pickle .	NG
the chief of staff pickled the fine delicious fine fine floor with the president in a pickled chief of staff on every fine pickled perplexed pickle .	GR
is it true that the chief of staff ate the delicious sandwich ?	GR
the sandwich with the chief of staff understood the delicious floor !	GR
a president kissed a pickle .	GR
the pickled chief of staff wanted the pickle under on pickle !	NG
the president wanted a fine chief of staff !	GR
is it true that a chief of staff pickled a the fine sandwich ?	NG
is it true that a chief of staff with the pickle ?	NG
a fine chief of staff in the with floor understood the president .	NG
the delicious pickle under the sandwich on pickled floor under a pickled president with the delicious pickle pickled a president .	NG
every floor understood on floor under the floor !	NG
the floor ate every president in wanted floor .	NG
is it true that the president pickled a pickle with a perplexed perplexed floor ?	GR
fine floor ate the fine floor !	NG
a floor ate the chief of staff !	GR
is it true that the sandwich understood the floor ?	GR
the fine pickle understood the pickled pickle on a floor .	GR
the floor wanted the delicious pickled floor .	GR
the pickled perplexed floor kissed the delicious sandwich .	GR
a chief of staff on the pickle under the fine pickled sandwich on a pickled pickled fine pickled delicious perplexed sandwich with a chief of staff under a floor ate a chief of staff !	GR
a chief of staff wanted the president !	GR
a floor pickled ate fine president .	NG
a pickle with the delicious pickled fine floor on the delicious on floor pickled the sandwich .	NG
a perplexed pickled on floor ate a pickled sandwich !	NG
the pickle perplexed a perplexed pickle .	NG
every floor with a sandwich on the pickled pickled sandwich on the delicious fine sandwich on a perplexed perplexed pickle in the president on every pickle in every pickled delicious perplexed fine sandwich understood the pickle !	GR
the pickle on a pickle ate a perplexed every fine pickle !	NG
is it true that a president on every fine floor a a floor under a sandwich ?	NG
a under perplexed pickle kissed the pickled sandwich .	NG
a fine sandwich with the fine pickle !	NG
is it true that with pickled president ate a chief of staff ?	NG
is it true that the pickled fine pickled delicious sandwich pickled the floor ?	GR
is it true that the president with the president kissed pickled pickled sandwich in the chief of staff ?	NG
is it true that a perplexed floor understood delicious chief of staff ?	NG
a fine pickle ate the pickle !	GR
is it true that the fine chief of staff in every chief of staff in a chief of staff on a sandwich a the floor ?	NG
a pickle ate a pickle !	GR
a sandwich under the pickled pickle ate every fine president .	GR
every delicious pickle under a fine perplexed floor ate kissed pickled pickle !	NG
every sandwich understood the fine perplexed sandwich .	GR
ate floor kissed the chief of staff .	NG
a chief of staff understood every pickle !	GR
is it true that the pickle ate a president on a perplexed president on the pickled floor in a pickle in the chief of staff in the president ?	GR
the perplexed chief of staff kissed in president on a sandwich with every pickle !	NG
every chief of staff pickled the delicious delicious wanted sandwich !	NG
a pickled perplexed chief of staff with the president on the delicious pickled floor kissed every president on the pickle with a pickled floor with the pickled perplexed pickle .	GR
is it true that understood president kissed a pickled sandwich ?	NG
is it true that a perplexed fine president understood a delicious perplexed pickle ?	GR
the chief of staff on every delicious fine delicious fine pickled pickled delicious sandwich pickled a perplexed sandwich !	GR
is it true that ate chief of staff on the pickle in every floor pickled the president ?	NG
is it true that a delicious chief of staff under a perplexed president under a floor with a chief of staff understood a fine chief of staff pickled the chief of staff with every delicious chief of staff ?	NG
is it true that every pickled floor pickled pickled chief of staff on every president ?	NG
every president wanted the fine chief of staff on the perplexed perplexed pickled president !	GR
every delicious fine chief of staff pickled kissed perplexed president .	NG
a chief of staff in the sandwich with a floor with a delicious fine perplexed pickled perplexed president on a with floor kissed a president .	NG
a pickle understood in fine sandwich !	NG
is it true that every floor understood every pickle ?	GR
the sandwich understood every president .	GR
a fine perplexed sandwich kissed a perplexed pickle under the pickled fine pickle !	GR
every perplexed floor pickled the delicious chief of staff on a floor under the sandwich .	GR
the president kissed a president !	GR
a president under a pickle pickled a perplexed president .	GR
is it true that a pickle pickled every pickle with delicious pickled fine floor ?	NG
the floor on the fine pickle !	NG
every delicious president kissed a pickle !	GR
the floor a the floor .	NG
is it true that the perplexed sandwich understood every fine president on a fine floor ?	GR
pickled sandwich pickled every pickled floor !	NG
is it true that the perplexed perplexed fine president pickled the fine perplexed pickle ?	GR
the chief of staff under a delicious sandwich kissed a president .	GR
a perplexed chief of staff wanted the sandwich .	GR
the sandwich ate delicious president !	NG
is it true that the sandwich with a chief of staff pickled the sandwich ?	GR
a floor pickled the pickle .	GR
a chief of staff wanted the pickle .	GR
a fine fine pickled pickled pickle under the floor understood every sandwich !	GR
every floor pickled the chief of staff !	GR
the floor pickled the delicious pickle under the sandwich !	GR
a sandwich under a perplexed pickled perplexed perplexed pickle wanted a perplexed delicious chief of staff !	GR
a chief of staff understood the president !	GR
the sandwich wanted pickled pickled president !	NG
is it true that every president pickled the sandwich ?	GR
a sandwich pickled the pickled perplexed sandwich .	GR
on president understood a president .	NG
a perplexed sandwich on the floor on a delicious sandwich understood a delicious chief of staff !	GR
a delicious fine president wanted every floor !	GR
a floor in the fine fine floor understood a pickle under a president .	GR
every perplexed sandwich on the pickle understood pickled president !	NG
the sandwich ate every fine fine pickle on wanted president !	NG
a sandwich wanted wanted floor !	NG
a perplexed fine pickled president under the pickle under a delicious perplexed perplexed sandwich under the pickled president wanted the president .	GR
the president with a delicious chief of staff pickled a pickled perplexed floor on the pickle .	GR
a chief of staff in the floor !	NG
the floor understood every understood president .	NG
is it true that a pickle understood the chief of staff ?	GR
a fine delicious perplexed fine delicious president wanted a pickle under every pickled sandwich .	GR
a perplexed delicious delicious floor wanted every sandwich in the pickled delicious pickled floor !	GR
a pickle kissed the a chief of staff .	NG
perplexed pickle pickled the floor !	NG
the pickle on the chief of staff under a president with the sandwich in a president wanted a president !	GR
is it true that the president in a floor in the sandwich on a chief of staff kissed a perplexed pickle ?	GR
a president on the pickled floor ate every sandwich .	GR
a sandwich pickled the pickle .	GR
is it true that the sandwich wanted a president on every president on a pickle every the president ?	NG
is it true that a sandwich with a floor under a president ?	NG
a president pickled the perplexed floor on a sandwich with a floor .	GR
a pickle perplexed a president .	NG
a pickle ate the president .	GR
is it true that the pickled president pickled the chief of staff ?	GR
the sandwich with every president understood a pickle .	GR
a delicious president wanted wanted fine sandwich !	NG
the fine floor ate a pickle !	GR
is it true that a floor understood a delicious floor ?	GR
is it true that the fine delicious chief of staff kissed the pickled floor ?	GR
the chief of staff ate every sandwich with the fine sandwich under a pickled sandwich with the chief of staff in every fine floor !	GR
the floor understood the chief of staff .	GR
a president a a sandwich !	NG
is it true that the fine delicious pickle ate every delicious floor ?	GR
a floor every a chief of staff !	NG
is it true that a sandwich in a sandwich with the sandwich with every floor on the chief of staff with every chief of staff the the chief of staff pickled the floor ?	NG
a sandwich kissed a pickled president !	GR
fine fine president ate a sandwich !	NG
is it true that a president with delicious delicious fine perplexed pickled pickle ate every sandwich ?	NG
is it true that under sandwich understood the sandwich ?	NG
the sandwich pickled a delicious with chief of staff !	NG
the delicious sandwich kissed the delicious floor !	GR
is it true that the sandwich under the delicious sandwich wanted the fine chief of staff under every perplexed sandwich ?	GR
is it true that a delicious pickle kissed the every sandwich ?	NG
every fine president pickled the perplexed perplexed floor !	GR
is it true that a sandwich kissed on fine chief of staff ?	NG
the president under a president under every chief of staff pickled every floor !	GR
the floor ate ate fine pickle under a perplexed president !	NG
the pickle under every sandwich with every pickled president ate the perplexed sandwich .	GR
a president ate fine pickle !	NG
is it true that the chief of staff understood the chief of staff under a fine floor ?	GR
a chief of staff with the sandwich kissed ate chief of staff .	NG
every perplexed chief of staff a a pickle !	NG
every pickle pickled in floor !	NG
the delicious chief of staff kissed a sandwich .	GR
the sandwich wanted under pickle .	NG
a chief of staff ate every chief of staff !	GR
every pickled ate pickled fine president pickled the chief of staff !	NG
is it true that a pickle pickled the pickle ?	GR
delicious pickle kissed a fine sandwich !	NG
is it true that on chief of staff kissed the pickled pickle ?	NG
a floor kissed a pickle .	GR
a pickled fine delicious pickle ate fine perplexed floor under a sandwich on a chief of staff !	NG
a pickle ate a pickled chief of staff .	GR
the sandwich kissed the president with the kissed president .	NG
a delicious the chief of staff wanted every pickled delicious president !	NG
understood perplexed pickle understood every sandwich .	NG
is it true that every chief of staff with a pickle under a delicious pickle with a perplexed sandwich with every president with the fine delicious fine pickle under the fine delicious sandwich with a floor with a chief of staff with a president under a chief of staff with every perplexed president wanted the delicious delicious chief of staff ?	GR
the sandwich a the sandwich !	NG
the president pickled the floor .	GR
is it true that every pickle on a perplexed president ate a a president ?	NG
is it true that every chief of staff pickled the delicious chief of staff ?	GR
fine pickled fine floor kissed the pickled president !	NG
a pickled pickle the the pickled perplexed fine president wanted a pickle !	NG
a chief of staff wanted the sandwich .	GR
is it true that a fine fine delicious sandwich under the delicious sandwich under the floor ?	NG
a fine chief of staff under every floor .	NG
is it true that the fine sandwich wanted a floor on the sandwich ?	GR
every pickle ate the sandwich with a sandwich !	GR
is it true that fine delicious pickled chief of staff pickled a floor with a sandwich ?	NG
the pickled president understood the pickled floor in a chief of staff .	GR
the sandwich with every fine chief of staff under the chief of staff wanted the chief of staff .	GR
the president kissed a pickle .	GR
is it true that the sandwich pickled the pickled perplexed pickle in a pickled chief of staff on wanted chief of staff ?	NG
a the delicious pickled president ate a president !	NG
is it true that the delicious pickle pickled a floor ?	GR
is it true that a fine president under the pickled sandwich ?	NG
the president pickled on pickled fine pickle !	NG
a fine fine ate floor pickled the floor .	NG
the sandwich on every perplexed floor under a floor on a floor !	NG
a pickle under a sandwich with the fine perplexed pickle kissed a floor !	GR
a fine chief of staff pickled the sandwich on the president !	GR
is it true that a in perplexed floor wanted a pickled president ?	NG
a president wanted every chief of staff .	GR
the pickle under a president !	NG
is it true that a president on every president pickled wanted perplexed fine pickle on a president ?	NG
is it true that every chief of staff wanted every chief of staff on every president ?	GR
is it true that a floor under every pickle understood a floor ?	GR
the ate delicious floor kissed the sandwich !	NG
a delicious chief of staff under a in fine delicious pickle kissed a pickle .	NG
is it true that the pickled sandwich with a president kissed a fine sandwich ?	GR
is it true that a pickled floor wanted the pickle ?	GR
is it true that the pickled pickled delicious pickled chief of staff ate the sandwich ?	GR
is it true that the fine chief of staff understood every chief of staff ?	GR
the perplexed fine president pickled a pickled pickle in the chief of staff !	GR
a delicious delicious chief of staff under a pickled delicious president on the chief of staff with a pickled pickle with the sandwich in a floor on the sandwich under the delicious chief of staff in a pickled president on the perplexed delicious perplexed president understood the sandwich .	GR
a president delicious every sandwich .	NG
is it true that the perplexed floor in the chief of staff under the pickled sandwich on the chief of staff kissed a chief of staff ?	GR
a floor pickled under pickle .	NG
is it true that the perplexed fine sandwich wanted the chief of staff perplexed a sandwich ?	NG
the delicious floor kissed the floor .	GR
every chief of staff wanted the floor !	GR
with pickled sandwich pickled a sandwich on the fine fine floor !	NG
is it true that a a floor wanted a fine pickled perplexed sandwich ?	NG
is it true that the sandwich under the delicious delicious chief of staff on the sandwich understood the sandwich ?	GR
the fine pickle understood a pickle !	GR
is it true that the floor ate the fine floor ?	GR
is it true that the sandwich kissed the floor ?	GR
is it true that on chief of staff pickled a sandwich ?	NG
the delicious perplexed sandwich under the perplexed president pickled the pickled pickled president !	GR
every chief of staff kissed a floor .	GR
is it true that the pickle kissed every floor ?	GR
is it true that a perplexed chief of staff in a pickle in on chief of staff on the perplexed delicious floor in a perplexed sandwich with the chief of staff wanted the sandwich ?	NG
is it true that the with sandwich ate the delicious perplexed sandwich ?	NG
a floor wanted the sandwich .	GR
is it true that the perplexed fine delicious wanted delicious delicious delicious president pickled the sandwich ?	NG
the pickled pickle perplexed the floor on the perplexed floor !	NG
a fine pickle pickled a chief of staff under every pickle on a chief of staff under the a sandwich in a perplexed president !	NG
a president understood the pickle .	GR
every sandwich ate a pickled perplexed perplexed chief of staff with the president under a chief of staff with every pickled floor .	GR
is it true that kissed president wanted a perplexed pickled pickle ?	NG
the perplexed perplexed floor under every fine floor ate every sandwich .	GR
the chief of staff on the sandwich understood the pickled pickle with the pickled sandwich on every pickle !	GR
is it true that the floor on the chief of staff pickled with president ?	NG
is it true that the perplexed president pickled a chief of staff ?	GR
a sandwich the every sandwich wanted a pickle !	NG
is it true that a floor kissed a president with a pickle in the delicious chief of staff the a chief of staff ?	NG
a delicious perplexed pickled delicious pickle pickled the pickle !	GR
the floor wanted a delicious fine president with in president .	NG
a chief of staff ate the perplexed perplexed president !	GR
the perplexed chief of staff on the delicious president on a sandwich with the floor with a delicious fine president understood a kissed pickled pickle with the delicious fine pickle .	NG
is it true that kissed pickled floor in a fine fine chief of staff wanted the chief of staff ?	NG
delicious floor understood the president .	NG
is it true that the pickled perplexed fine floor in the president understood the sandwich ?	GR
the delicious fine perplexed perplexed pickle ate the perplexed fine sandwich !	GR
every delicious chief of staff on the perplexed fine the pickle on a president with the chief of staff in every chief of staff ate every president .	NG
every sandwich kissed delicious delicious floor .	NG
is it true that every pickled chief of staff wanted a president ?	GR
every chief of staff understood a a pickle !	NG
every delicious floor wanted every perplexed chief of staff .	GR
is it true that a perplexed pickle under a floor kissed the chief of staff ?	GR
is it true that the delicious chief of staff kissed with floor with every fine perplexed sandwich ?	NG
pickled sandwich wanted the sandwich .	NG
is it true that the perplexed president with a perplexed sandwich kissed a sandwich ?	GR
kissed fine pickle wanted the sandwich .	NG
is it true that the delicious delicious floor understood a chief of staff ?	GR
is it true that a pickle wanted a on chief of staff ?	NG
a perplexed delicious chief of staff ate a sandwich !	GR
the president under a floor pickled a floor with a pickle with a sandwich .	GR
is it true that the floor wanted a delicious pickle ?	GR
delicious chief of staff ate the sandwich !	NG
the chief of staff kissed wanted president !	NG
is it true that under pickled fine president with a floor pickled a chief of staff ?	NG
a pickled sandwich pickled pickled floor .	NG
is it true that a fine delicious perplexed perplexed pickle kissed the delicious delicious president under the perplexed pickled perplexed pickle under the chief of staff in a sandwich ?	GR
the perplexed delicious floor ate a pickle in the chief of staff with a president .	GR
a delicious chief of staff wanted a pickle !	GR
a pickle understood with president .	NG
the delicious president wanted every president .	GR
kissed chief of staff pickled the perplexed fine pickle !	NG
is it true that a pickled president wanted on president ?	NG
every pickle in a pickle ate a fine president under every sandwich under every perplexed president !	GR
a sandwich kissed in chief of staff .	NG
every president pickled the floor !	GR
the sandwich ate a delicious president .	GR
a delicious president wanted a perplexed sandwich !	GR
is it true that a sandwich ate a delicious pickled perplexed kissed sandwich ?	NG
is it true that every pickled pickle wanted a pickled pickle ?	GR
on chief of staff understood a fine floor .	NG
is it true that the pickle every a pickle ?	NG
is it true that a sandwich wanted the delicious pickle in every floor under a delicious chief of staff in a sandwich under in chief of staff with the pickle with the delicious president ?	NG
a president ate every delicious perplexed floor .	GR
pickled fine chief of staff in every president wanted the fine pickle in the delicious president on a perplexed chief of staff !	NG
pickled pickle understood a president .	NG
a pickle with the pickle fine the perplexed pickled president wanted the pickled floor .	NG
a fine pickled sandwich under a president a a delicious sandwich wanted the pickle .	NG
a pickled fine delicious floor understood a floor .	GR
is it true that the under pickled sandwich under a pickled pickle with a perplexed president under every floor wanted a floor ?	NG
a president wanted a pickled president !	GR
the perplexed pickle with a sandwich in the fine president ate the perplexed president .	GR
is it true that the fine delicious president pickled the chief of staff ?	GR
every delicious president in the delicious president ate every pickled chief of staff .	GR
is it true that the fine president fine a pickle ?	NG
the president understood the floor .	GR
the president understood the president under the pickle !	GR
a floor kissed delicious fine delicious pickle !	NG
is it true that the pickle ate a president ?	GR
the under sandwich ate a sandwich .	NG
the president a the pickle in a perplexed chief of staff .	NG
is it true that a floor pickled the floor under every pickle ?	GR
is it true that the sandwich understood every perplexed pickle ?	GR
the sandwich kissed in sandwich .	NG
a sandwich on the fine pickle with a floor pickled a chief of staff with a chief of staff !	GR
is it true that the sandwich the every president under the pickled fine pickle kissed the pickled fine delicious pickle ?	NG
is it true that the chief of staff in the chief of staff on every delicious chief of staff with every perplexed pickle in a fine pickle in a chief of staff wanted the fine floor under a chief of staff ?	GR
a fine chief of staff pickled a sandwich .	GR
the delicious chief of staff on the perplexed president with a sandwich understood a floor !	GR
every president understood a perplexed pickled sandwich .	GR
a pickle under the chief of staff perplexed a pickle .	NG
is it true that a president wanted delicious sandwich ?	NG
is it true that the delicious sandwich on every chief of staff on a delicious delicious under fine pickle on the fine floor understood every delicious sandwich ?	NG
the perplexed fine sandwich pickled the president !	GR
a chief of staff pickled the sandwich in the pickled president !	GR
a fine pickled delicious pickle wanted the pickle .	GR
a pickle kissed every floor in wanted delicious president in a president .	NG
is it true that the delicious chief of staff with a president on a perplexed pickle understood a sandwich ?	GR
under fine fine floor understood every president .	NG
a chief of staff wanted with sandwich .	NG
a pickle ate a pickle .	GR
a pickled delicious perplexed pickle fine the floor .	NG
the pickle understood pickled sandwich on the sandwich on the chief of staff in the perplexed pickle on a pickled floor !	NG
is it true that a president with every fine chief of staff ?	NG
a pickle ate a floor .	GR
a chief of staff wanted on pickle !	NG
a president pickled a president !	GR
is it true that the perplexed perplexed perplexed delicious fine chief of staff ate a president under the president with a perplexed president ?	GR
is it true that the floor with a president with pickled sandwich kissed a fine chief of staff ?	NG
is it true that the sandwich pickled a floor ?	GR
the chief of staff ate a pickled floor .	GR
a sandwich understood a pickle !	GR
the pickled pickle with the delicious pickled president .	NG
the pickle wanted the a delicious pickle in a chief of staff in a perplexed floor under every chief of staff on a pickle .	NG
the pickle with a pickle under the chief of staff pickled a perplexed chief of staff !	GR
is it true that a sandwich wanted a perplexed the fine pickled president ?	NG
the chief of staff a every president .	NG
is it true that a president with a chief of staff with the fine delicious pickle with a president ?	NG
wanted president kissed the fine floor !	NG
pickled fine chief of staff under a delicious chief of staff pickled a sandwich !	NG
the pickled pickled sandwich understood a pickled pickled delicious sandwich .	GR
a pickled perplexed pickled pickle kissed kissed president !	NG
is it true that a floor every a pickle ?	NG
is it true that the floor wanted every fine sandwich ?	GR
every floor pickled a delicious delicious pickle on the delicious floor on the perplexed ate floor !	NG
the chief of staff on a pickle in the president on a delicious chief of staff under a delicious chief of staff understood the president wanted the sandwich !	NG
is it true that a floor ate the pickled delicious pickle ?	GR
the floor with the chief of staff pickled a pickle .	GR
the president ate a pickle in the ate pickle .	NG
is it true that every floor on every perplexed president in a pickled sandwich pickled a president ?	GR
the president ate every sandwich under in pickle !	NG
the perplexed sandwich with the president wanted every chief of staff .	GR
is it true that a perplexed delicious president with the pickled floor understood wanted perplexed floor in the floor ?	NG
fine sandwich ate the fine president !	NG
is it true that a ate pickle ate every sandwich under a chief of staff ?	NG
the pickle a the floor .	NG
the president with every floor on a fine floor on a fine president in the president with a floor perplexed a floor !	NG
a sandwich pickled the pickle under a pickle !	GR
is it true that the president understood the sandwich in a pickle ?	GR
is it true that understood pickle wanted every sandwich ?	NG
a perplexed pickle wanted a chief of staff !	GR
the president ate pickled fine pickled pickle !	NG
the chief of staff pickled the floor .	GR
a chief of staff understood a pickled sandwich with a perplexed fine pickled sandwich in a sandwich with the pickled pickle .	GR
is it true that a sandwich pickled a pickled pickled delicious chief of staff under the pickle under a pickle ?	GR
the perplexed president in the president ate the sandwich .	GR
is it true that a delicious president delicious a fine pickle ?	NG
a chief of staff kissed understood perplexed sandwich .	NG
a perplexed chief of staff understood a chief of staff !	GR
the sandwich ate ate sandwich .	NG
a chief of staff wanted a pickled sandwich in fine pickle !	NG
a pickle kissed the fine sandwich !	GR
a president with the pickled perplexed floor understood every chief of staff !	GR
is it true that a the chief of staff wanted the perplexed pickle ?	NG
ate perplexed delicious pickled chief of staff with every floor under every sandwich with the pickle kissed every pickled sandwich on a pickle .	NG
every pickled perplexed sandwich a the pickle .	NG
a fine fine delicious sandwich understood a chief of staff .	GR
is it true that the floor a the pickled president ?	NG
a chief of staff under the floor with with delicious chief of staff wanted the chief of staff !	NG
is it true that the pickled pickle in a pickle ate the chief of staff ?	GR
a chief of staff wanted in floor !	NG
a sandwich wanted every pickled president in a sandwich on a sandwich with every president !	GR
the perplexed pickled pickled president ate the perplexed floor !	GR
every wanted pickled fine sandwich kissed a pickled floor .	NG
a pickled president on a floor with every chief of staff on a sandwich understood every president !	GR
a pickle kissed a fine sandwich !	GR
the delicious president wanted a sandwich under every president on the pickle on the pickle under the delicious chief of staff !	GR
is it true that delicious pickled perplexed fine floor ate a fine president ?	NG
is it true that a pickled pickle ate a sandwich on a chief of staff on the president in a pickle ?	GR
is it true that the pickled fine pickle on a delicious fine pickled perplexed fine sandwich ate a sandwich with a perplexed pickled sandwich ?	GR
is it true that a pickle pickled every sandwich ?	GR
is it true that fine chief of staff pickled a floor ?	NG
is it true that a sandwich wanted a fine sandwich pickled a perplexed floor ?	NG
the fine chief of staff ate a sandwich .	GR
the chief of staff under a delicious floor fine the sandwich .	NG
is it true that the delicious delicious sandwich a the delicious pickled pickle ?	NG
the pickle wanted the sandwich under a president on a fine fine pickle !	GR
is it true that a pickle understood the sandwich on the pickle on a sandwich under a delicious pickle in the pickle in a chief of staff ?	GR
is it true that the president a a president with the fine president kissed a sandwich ?	NG
is it true that a pickle with a delicious floor ?	NG
is it true that a chief of staff a a sandwich ?	NG
the pickled perplexed chief of staff ate every perplexed sandwich .	GR
is it true that the pickle understood the chief of staff ?	GR
a chief of staff kissed the floor .	GR
the sandwich on every chief of staff in the sandwich wanted the pickle .	GR
a chief of staff fine the floor !	NG
every chief of staff in a delicious floor in a floor pickled a fine sandwich .	GR
is it true that the president in a sandwich under every chief of staff wanted a pickle ?	GR
is it true that a perplexed president the the chief of staff ?	NG
a fine chief of staff wanted a floor !	GR
the pickle kissed the sandwich on the chief of staff on the pickle !	GR
is it true that a delicious president under a perplexed pickle kissed the sandwich ?	GR
a floor kissed a delicious delicious president with fine president !	NG
every chief of staff wanted a with pickled fine sandwich on the president .	NG
the perplexed fine floor pickled the delicious president .	GR
is it true that every sandwich kissed every chief of staff in every floor with the president with the pickle ?	GR
is it true that perplexed president wanted the sandwich ?	NG
the pickle in the sandwich kissed a sandwich !	GR
the floor understood the delicious perplexed fine fine delicious delicious delicious floor !	GR
a president a every delicious sandwich !	NG
is it true that the sandwich understood understood sandwich ?	NG
is it true that the floor with every floor with delicious perplexed pickle kissed a chief of staff ?	NG
the pickle ate a fine delicious floor !	GR
is it true that the chief of staff understood a delicious pickle ?	GR
is it true that a fine sandwich pickled every floor ?	GR
is it true that perplexed president on a president understood the pickle ?	NG
is it true that every sandwich kissed the chief of staff ?	GR
is it true that wanted pickle understood the pickle ?	NG
perplexed president understood every president .	NG
a delicious president kissed a pickle on the floor with the fine sandwich !	GR
the chief of staff in the perplexed pickle in a president kissed pickled sandwich in every delicious floor on the floor !	NG
understood president ate the delicious sandwich .	NG
the floor understood a perplexed floor .	GR
is it true that the floor in the pickle ?	NG
the floor kissed a pickle !	GR
a sandwich ate the delicious sandwich .	GR
the floor in perplexed president under the president wanted the delicious sandwich .	NG
the pickle pickled the floor !	GR
a pickle on a president .	NG
is it true that the fine floor kissed the pickled floor ?	GR
is it true that a chief of staff wanted wanted president ?	NG
the president understood perplexed delicious sandwich .	NG
a sandwich in the pickled sandwich with a pickle kissed the fine delicious president .	GR
every floor every the pickled president under the fine pickle !	NG
is it true that every pickle wanted the president with the delicious floor in a every delicious perplexed pickled delicious floor ?	NG
the delicious president kissed a the chief of staff !	NG
with pickle wanted every chief of staff .	NG
a pickled fine floor kissed pickled pickle .	NG
the pickled sandwich in the floor ate a sandwich on the pickled pickle under a pickle .	GR
the chief of staff understood a chief of staff !	GR
a floor ate fine perplexed pickle .	NG
a pickle every the pickle ate the floor under a fine chief of staff .	NG
the floor pickled a sandwich !	GR
is it true that the perplexed fine perplexed chief of staff understood every fine chief of staff ?	GR
is it true that a president understood a president ?	GR
the sandwich kissed a delicious sandwich .	GR
a floor under a president the the floor .	NG
the sandwich understood a president .	GR
a president in kissed chief of staff on a delicious floor on the chief of staff kissed a sandwich in the president !	NG
is it true that a pickle kissed the delicious perplexed president ?	GR
delicious fine fine fine pickled president ate every pickle .	NG
in chief of staff ate a chief of staff !	NG
is it true that every president understood kissed president ?	NG
a fine pickled fine president understood a fine chief of staff .	GR
is it true that a fine chief of staff wanted a president ?	GR
is it true that every perplexed president wanted every pickle ?	GR
the sandwich in the pickled fine sandwich on the chief of staff wanted a floor !	GR
the fine sandwich understood the fine delicious floor .	GR
the president wanted every sandwich !	GR
a perplexed president kissed under pickle !	NG
the pickle kissed the the sandwich with every pickle under the pickled sandwich in the pickle !	NG
a president ate the perplexed sandwich !	GR
is it true that a perplexed pickle kissed a perplexed delicious president with the chief of staff in every sandwich on the pickle ?	GR
the pickle kissed a floor on the delicious chief of staff !	GR
the president wanted a fine president the the president .	NG
is it true that a floor understood a president under delicious chief of staff ?	NG
a sandwich wanted a pickled pickled president in the delicious chief of staff in a sandwich .	GR
is it true that every chief of staff understood the president ?	GR
every chief of staff under a sandwich ate every president .	GR
the pickled floor under the fine pickle on every chief of staff under a fine chief of staff wanted a president !	GR
a floor pickled the fine president .	GR
the fine pickle in the president on every fine floor under a fine sandwich kissed the president .	GR
is it true that a sandwich wanted the pickle with the floor in delicious sandwich ?	NG
is it true that the on sandwich understood the chief of staff ?	NG
is it true that the floor ate a pickle ?	GR
is it true that a pickle understood a president ?	GR
perplexed chief of staff kissed the delicious floor !	NG
the pickled pickled president with a president understood the pickled delicious pickle on every sandwich with a perplexed sandwich .	GR
a pickle pickled ate sandwich .	NG
a president in a floor with a pickled president wanted every president !	GR
a perplexed sandwich wanted every perplexed chief of staff .	GR
the fine chief of staff wanted every perplexed kissed president !	NG
is it true that the sandwich every a sandwich in a pickle on a perplexed sandwich ?	NG
a sandwich kissed the pickle under a delicious president with the floor under a pickle .	GR
every floor perplexed the pickle .	NG
a fine fine sandwich pickled a pickled delicious president wanted a perplexed delicious sandwich with a floor in the floor on the floor on a fine sandwich !	NG
a sandwich pickled fine pickle !	NG
is it true that the pickled pickled president kissed the pickle ?	GR
is it true that the pickle a a sandwich ?	NG
the pickle kissed with president .	NG
a pickled pickle kissed every floor with the delicious floor .	GR
a pickled sandwich understood a pickled sandwich .	GR
is it true that a floor ate the chief of staff ?	GR
the perplexed sandwich understood fine president !	NG
a chief of staff perplexed every pickled floor !	NG
is it true that a floor understood the fine sandwich in the fine president ?	GR
the pickle with the president !	NG
a in sandwich understood a floor .	NG
a president the a fine president !	NG
the pickle in a delicious sandwich in a perplexed sandwich wanted a chief of staff a every pickle !	NG
every chief of staff ate perplexed pickled pickle .	NG
a sandwich kissed fine perplexed sandwich !	NG
is it true that the floor with a floor pickled the president ?	GR
is it true that every pickled pickled sandwich understood every perplexed perplexed sandwich on every delicious sandwich with the president ?	GR
every fine president understood ate floor .	NG
pickled chief of staff wanted the pickle !	NG
is it true that every sandwich ate under pickle with a president ?	NG
is it true that a chief of staff a the floor wanted a sandwich ?	NG
is it true that a president in the delicious delicious fine delicious pickle a the pickle under a president ate a floor ?	NG
is it true that the sandwich understood the delicious president ?	GR
is it true that the pickle pickled a delicious pickle ?	GR
a chief of staff wanted the fine fine perplexed perplexed floor .	GR
is it true that a president ate a sandwich ?	GR
a president ate a pickled pickled president on a chief of staff .	GR
perplexed perplexed pickle understood a pickle on a sandwich !	NG
is it true that the a pickle in a pickle ate the chief of staff ?	NG
is it true that a chief of staff understood the fine in pickle ?	NG
the delicious pickled pickle ate every sandwich !	GR
a perplexed fine pickled pickled pickle ate the chief of staff under a pickled sandwich in the pickled perplexed perplexed sandwich .	GR
the perplexed president wanted a pickle with every pickle with the pickled sandwich understood the president .	NG
is it true that the pickle on pickled perplexed sandwich kissed every floor ?	NG
is it true that every chief of staff ate fine sandwich ?	NG
a pickled fine floor kissed a president !	GR
is it true that every sandwich kissed pickled chief of staff ?	NG
the floor under every pickle on every chief of staff with a perplexed president with every pickled president wanted the sandwich .	GR
a floor perplexed the fine sandwich .	NG
a chief of staff with a president with every fine fine chief of staff with a pickled fine pickle under every pickle in a pickled floor wanted the chief of staff .	GR
is it true that every perplexed delicious floor kissed the president ?	GR
a delicious floor ate the pickled floor !	GR
the president ate the floor .	GR
is it true that the sandwich the a chief of staff ?	NG
a a chief of staff understood the fine fine fine president .	NG
the fine pickled fine chief of staff under every chief of staff kissed a wanted floor !	NG
is it true that under chief of staff pickled the president ?	NG
a floor perplexed a pickled perplexed pickle !	NG
the sandwich every the president .	NG
the delicious president kissed the sandwich !	GR
is it true that a pickled chief of staff ate every perplexed fine floor with a pickle under ate pickle ?	NG
is it true that every pickled chief of staff under a perplexed sandwich understood understood floor ?	NG
a pickle kissed the floor !	GR
the pickle kissed delicious delicious sandwich !	NG
the sandwich ate a pickled chief of staff !	GR
is it true that the president understood the floor ?	GR
is it true that the floor wanted the perplexed sandwich ?	GR
is it true that a perplexed pickle ate understood pickled floor ?	NG
the sandwich with a pickle kissed the sandwich !	GR
the perplexed sandwich in a perplexed chief of staff on pickled perplexed pickled fine perplexed sandwich under every floor in every delicious sandwich kissed a pickle !	NG
a perplexed president understood the fine president .	GR
a fine pickled pickled chief of staff kissed the chief of staff !	GR
a perplexed chief of staff on the fine chief of staff ate the sandwich !	GR
a floor pickled a delicious pickle on every sandwich on the floor kissed the fine pickle !	NG
every sandwich under a president understood a pickled chief of staff !	GR
the floor kissed delicious pickle .	NG
pickled floor with the floor understood the president .	NG
a sandwich kissed the chief of staff with the president with the fine delicious pickle !	GR
is it true that the perplexed perplexed perplexed fine perplexed delicious chief of staff kissed the floor in the chief of staff under a pickle in a president on the sandwich ?	GR
a pickle ate the pickled delicious delicious pickle under a pickled pickled president !	GR
every delicious perplexed pickle on the floor on the perplexed pickle with a delicious president on the pickle on the floor .	NG
the sandwich ate every fine president !	GR
a pickle with the perplexed pickle pickled a chief of staff with kissed pickle .	NG
a floor understood wanted president with every delicious perplexed president in a pickle !	NG
is it true that the pickled pickled perplexed floor in the chief of staff on fine floor under every pickle kissed a pickle ?	NG
the president kissed the chief of staff .	GR
the perplexed delicious fine pickle ate every wanted perplexed chief of staff !	NG
under president ate a floor with a sandwich !	NG
is it true that every delicious pickle understood delicious floor in a floor ?	NG
is it true that a chief of staff understood the fine delicious fine president with a perplexed perplexed pickle ?	GR
a perplexed pickled fine chief of staff ate the pickle under a pickled pickled president under a chief of staff in the sandwich .	GR
is it true that a pickle wanted every fine floor under with fine floor ?	NG
is it true that a sandwich under the pickle with a sandwich pickled every sandwich in every floor under every chief of staff ?	GR
in chief of staff kissed a president !	NG
is it true that under pickled perplexed fine fine chief of staff ate the president ?	NG
is it true that a perplexed delicious pickle in the delicious perplexed pickle under a sandwich understood a pickled delicious floor ?	GR
ate pickled president with every sandwich wanted the chief of staff .	NG
is it true that the perplexed sandwich pickled a pickle ?	GR
the floor in every pickle kissed every president !	GR
every pickle pickled the pickle with a chief of staff with the chief of staff in the president .	GR
a sandwich delicious the floor in a pickled fine chief of staff in the perplexed pickle on the floor under every pickle .	NG
is it true that pickled pickle in a pickled fine perplexed chief of staff kissed every pickled fine perplexed pickled pickle ?	NG
is it true that the president with a president ?	NG
the sandwich ate a chief of staff .	GR
a president on a delicious president understood a the pickled sandwich !	NG
is it true that a sandwich ate in sandwich ?	NG
is it true that the fine chief of staff under a floor under a perplexed chief of staff on the delicious president wanted ate pickled pickled fine president ?	NG
is it true that the every pickle ate a sandwich ?	NG
is it true that a perplexed fine chief of staff ate the delicious sandwich ?	GR
is it true that a fine with sandwich pickled the sandwich ?	NG
a delicious sandwich ate in chief of staff !	NG
is it true that a fine pickled chief of staff kissed a pickled perplexed chief of staff ?	GR
pickled chief of staff understood a pickle !	NG
every fine pickled sandwich ate delicious pickle under a chief of staff .	NG
a chief of staff with a floor on the sandwich with a floor with every perplexed floor in the president on the chief of staff in the pickle on the perplexed fine pickle the a president on the floor under a fine chief of staff kissed the pickle in the chief of staff !	NG
is it true that the sandwich kissed the pickle ?	GR
a sandwich pickled the sandwich !	GR
the floor pickled every the president !	NG
is it true that a chief of staff perplexed the fine sandwich ?	NG
is it true that delicious chief of staff understood the fine sandwich on every pickle ?	NG
a delicious pickle understood a chief of staff !	GR
a floor pickled the pickled pickle !	GR
is it true that a president the a chief of staff ?	NG
a the pickled floor understood the pickled delicious chief of staff in the chief of staff .	NG
a sandwich wanted pickled fine sandwich .	NG
the pickle pickled the pickle under a delicious sandwich with the floor a a fine pickled floor !	NG
the pickled president kissed with chief of staff under the floor .	NG
the floor pickled the sandwich .	GR
every pickled fine sandwich wanted a sandwich !	GR
is it true that every chief of staff ate a sandwich ?	GR
the floor understood the pickle !	GR
the perplexed president with the chief of staff understood a pickled delicious pickled fine chief of staff !	GR
is it true that pickled fine floor ate a chief of staff on every chief of staff ?	NG
a pickle ate a sandwich .	GR
every pickled delicious pickled perplexed sandwich ate the sandwich .	GR
a fine fine perplexed sandwich under the president wanted the chief of staff !	GR
the president with the floor with the chief of staff with a pickle delicious the president wanted every sandwich .	NG
wanted fine sandwich under a perplexed pickle wanted a floor .	NG
is it true that the floor wanted the chief of staff under a sandwich with the pickle on a pickle in in chief of staff on the president ?	NG
kissed chief of staff understood the chief of staff .	NG
the pickled sandwich understood a delicious pickled president .	GR
in president ate a pickled fine president !	NG
is it true that a sandwich a the delicious delicious sandwich ?	NG
the pickle understood the sandwich .	GR
is it true that a sandwich ate a perplexed floor on a fine president ?	GR
the president wanted the president on the pickled sandwich under the fine chief of staff !	GR
is it true that the pickled president under understood chief of staff ate the chief of staff ?	NG
every fine president ate the president .	GR
a with pickled floor kissed a floor !	NG
a pickle understood the pickled pickled floor in every floor delicious the president in the chief of staff !	NG
a sandwich understood every chief of staff .	GR
is it true that a sandwich with the chief of staff kissed the pickle on the chief of staff ?	GR
is it true that a pickled understood delicious delicious delicious pickle kissed a pickled perplexed pickled floor ?	NG
is it true that every president understood a pickle ?	GR
a president wanted the perplexed president under a chief of staff .	GR
is it true that a sandwich in the perplexed perplexed sandwich understood every delicious floor ?	GR
a sandwich a the floor !	NG
is it true that a fine sandwich with every pickled chief of staff under the pickled president kissed the a pickled floor ?	NG
is it true that kissed delicious fine floor ate the president ?	NG
a floor wanted the fine pickle on every pickled sandwich !	GR
a sandwich in the president on a pickled pickle with every perplexed president in the pickled perplexed pickle kissed a chief of staff !	GR
a pickle ate every delicious fine president .	GR
under president kissed the sandwich .	NG
is it true that every on perplexed delicious sandwich understood the chief of staff with every pickle in the sandwich ?	NG
is it true that a chief of staff with fine fine delicious floor pickled the pickled chief of staff ?	NG
the pickle a a sandwich !	NG
the pickle with the sandwich .	NG
the president understood the fine delicious chief of staff on a perplexed sandwich with a pickled floor .	GR
is it true that the pickle the every chief of staff ?	NG
is it true that a fine floor with a sandwich understood the perplexed president ?	GR
is it true that the chief of staff ate on pickled sandwich ?	NG
is it true that the sandwich kissed the delicious delicious perplexed floor ?	GR
a sandwich with a chief of staff pickled a president !	GR
the delicious pickle understood every pickled sandwich with every perplexed perplexed sandwich in pickled pickled delicious pickled pickled chief of staff .	NG
is it true that every fine perplexed president with a perplexed delicious delicious president understood the fine president ?	GR
with pickle on the perplexed floor under the president kissed every delicious delicious pickled pickled president .	NG
the sandwich a the chief of staff understood the chief of staff .	NG
a delicious pickle kissed on sandwich !	NG
is it true that the delicious chief of staff on the perplexed chief of staff kissed the floor ?	GR
is it true that a pickle kissed a fine floor ?	GR
the floor kissed every sandwich in the sandwich in every president .	GR
every pickled delicious delicious pickle understood a chief of staff .	GR
is it true that the sandwich kissed the president under every floor ?	GR
the perplexed perplexed floor the the floor .	NG
is it true that the pickled fine pickle ate a pickle under the floor ?	GR
is it true that the floor under the sandwich wanted the chief of staff ?	GR
the pickle ate a fine delicious pickled chief of staff on the president .	GR
is it true that a pickled sandwich in every president with a floor understood a president ?	GR
is it true that the president kissed the pickle ?	GR
every fine chief of staff delicious every president with a pickle in the president .	NG
is it true that every pickle kissed a pickle ?	GR
is it true that the pickled sandwich ate perplexed floor ?	NG
a fine chief of staff wanted a perplexed fine perplexed pickle in the floor !	GR
a pickled chief of staff every a fine president !	NG
a fine president ate a sandwich !	GR
is it true that a delicious in chief of staff wanted a sandwich ?	NG
a chief of staff wanted every chief of staff on a chief of staff in a fine pickle on a delicious pickle in the pickled floor under the pickled pickle with a perplexed floor in the floor under a pickle under under pickled floor on the delicious sandwich !	NG
the pickle in every perplexed perplexed floor pickled a fine president .	GR
a perplexed president pickled the floor !	GR
the delicious pickle ate a delicious a president .	NG
the perplexed chief of staff fine a president !	NG
the pickle wanted a perplexed pickle .	GR
is it true that a pickled president wanted every fine perplexed perplexed sandwich ?	GR
a pickled chief of staff in the president with every pickle with the fine perplexed fine fine chief of staff in a sandwich pickled with perplexed pickled sandwich !	NG
a pickle understood the pickled floor under a chief of staff .	GR
is it true that with floor ate a perplexed sandwich ?	NG
the sandwich kissed the sandwich !	GR
is it true that the chief of staff ate a delicious president ?	GR
the pickle ate a perplexed pickle .	GR
the delicious sandwich ate with sandwich under the pickle !	NG
the floor on every chief of staff on the chief of staff under a president with a delicious pickle in the perplexed delicious sandwich kissed every delicious sandwich on the perplexed chief of staff under the floor !	GR
a delicious chief of staff kissed on fine pickled floor on the sandwich .	NG
a perplexed fine pickle pickled delicious sandwich .	NG
is it true that the pickle pickled the pickled wanted floor ?	NG
a fine chief of staff wanted a president !	GR
is it true that a chief of staff wanted a pickle on a sandwich ?	GR
the fine floor with a perplexed sandwich kissed a pickle .	GR
a pickle wanted the pickled president .	GR
is it true that a pickled fine floor understood a chief of staff ?	GR
in pickle wanted a pickled delicious president !	NG
is it true that a pickle on a pickle the the pickled chief of staff under the chief of staff with the pickled pickled chief of staff under every floor under the president pickled the sandwich ?	NG
the president in wanted pickled perplexed perplexed pickled floor kissed a floor .	NG
the delicious fine pickle under a sandwich with every sandwich pickled a pickle under every perplexed delicious floor on a pickled president .	GR
is it true that every president under the delicious floor ?	NG
is it true that the perplexed fine fine fine delicious pickle wanted a president ?	GR
is it true that a chief of staff pickled a pickle on a sandwich in a pickled perplexed fine pickled chief of staff on the pickle ?	GR
the delicious chief of staff wanted the president !	GR
is it true that the sandwich understood the president ?	GR
a fine sandwich under a chief of staff pickled perplexed sandwich .	NG
is it true that the pickle ate a delicious pickled chief of staff ?	GR
the perplexed president wanted a pickle .	GR
the floor kissed the sandwich !	GR
a president under the delicious perplexed sandwich kissed a sandwich !	GR
a floor under a sandwich on a floor !	NG
every sandwich kissed a pickled president !	GR
the perplexed pickle with a pickle pickled a floor with the fine delicious president !	GR
the floor under every floor under the perplexed perplexed pickle kissed the president !	GR
is it true that a sandwich wanted the president under a fine president in the delicious pickled fine president in every pickled sandwich ?	GR
the chief of staff in a floor .	NG
every floor kissed a pickle in a chief of staff on a pickle with the sandwich in a sandwich !	GR
the sandwich understood a perplexed chief of staff on fine chief of staff under the sandwich in a president .	NG
every pickled president under a president ate on perplexed sandwich .	NG
the pickled perplexed sandwich understood the floor !	GR
a the floor kissed a pickled president in the fine floor under a delicious delicious pickled president !	NG
is it true that a president with pickled chief of staff ate a chief of staff ?	NG
a president kissed a sandwich under a fine sandwich .	GR
a floor in every perplexed pickle in a fine pickled pickled sandwich on a pickle ate a president .	GR
the fine chief of staff kissed a floor .	GR
a fine delicious pickle ate a chief of staff .	GR
a pickled sandwich kissed a delicious sandwich .	GR
every perplexed delicious president kissed understood pickled delicious pickle .	NG
the pickle kissed a floor !	GR
the floor fine the floor pickled every chief of staff !	NG
is it true that a pickled pickled pickle ate a floor ?	GR
is it true that the floor pickled the chief of staff under the delicious pickle in the chief of staff ?	GR
a pickled pickled perplexed floor ate on chief of staff under the chief of staff .	NG
is it true that the delicious floor kissed a fine floor on with pickle ?	NG
is it true that a fine perplexed sandwich ate a perplexed floor ?	GR
is it true that every sandwich kissed a pickle with a floor ?	GR
every chief of staff under a pickled chief of staff understood the president .	GR
is it true that pickled perplexed sandwich wanted every perplexed pickle ?	NG
a sandwich kissed a floor in a floor with the president .	GR
the pickle under a pickle under a pickled pickle understood the chief of staff .	GR
every floor with every president understood the chief of staff !	GR
a sandwich wanted a perplexed fine chief of staff !	GR
is it true that the floor in the president in a fine perplexed fine pickled pickle under a chief of staff with a pickle under a president in the perplexed pickle in the chief of staff understood the pickle in every perplexed pickle ?	GR
is it true that every perplexed floor wanted the floor ?	GR
is it true that a chief of staff ate pickled president ?	NG
every fine perplexed pickled delicious perplexed floor kissed the delicious chief of staff !	GR
a fine president kissed a pickle .	GR
the pickled pickle ate a fine president with a floor .	GR
pickled pickle wanted the chief of staff !	NG
every a president pickled a pickle !	NG
a the fine perplexed floor kissed the pickle !	NG
a sandwich ate the pickle !	GR
a chief of staff in the pickled pickle !	NG
the pickled fine perplexed pickled pickle understood under chief of staff !	NG
the president perplexed the floor !	NG
is it true that the perplexed pickled delicious delicious perplexed president fine the perplexed floor ?	NG
is it true that the perplexed chief of staff kissed pickled president ?	NG
the wanted pickle kissed the pickled delicious perplexed chief of staff .	NG
is it true that the pickled sandwich on the chief of staff ?	NG
the fine pickle wanted a president .	GR
a chief of staff pickled the floor !	GR
the sandwich pickled every floor .	GR
is it true that the floor understood the sandwich ?	GR
a chief of staff ate a sandwich !	GR
the delicious president under every sandwich under a president in the pickle in the president under every sandwich with a chief of staff ate the pickle on a floor in the perplexed floor under a perplexed pickled sandwich on a pickled pickle .	GR
the on pickled chief of staff pickled the pickle with a floor .	NG
a pickle in the pickle ate the pickled perplexed pickle .	GR
a delicious on pickle pickled a floor !	NG
every sandwich ate the pickled sandwich .	GR
a floor with a pickled president under every floor with a pickled fine pickle ate the delicious president !	GR
is it true that every president ate the pickle a a chief of staff on the pickled pickled fine sandwich ?	NG
a delicious perplexed sandwich wanted under pickle .	NG
a chief of staff on the sandwich under a president the the pickled pickle kissed the chief of staff .	NG
is it true that a president under the perplexed floor understood a sandwich ?	GR
the pickle ate the perplexed a chief of staff !	NG
is it true that the pickled chief of staff understood the president pickled the fine floor ?	NG
a perplexed president pickled the sandwich .	GR
is it true that the kissed chief of staff wanted every floor ?	NG
is it true that a pickle ate every sandwich in the perplexed floor in a pickle under a chief of staff in the pickle ?	GR
a delicious fine delicious sandwich ate a sandwich .	GR
the floor the the perplexed sandwich wanted a floor !	NG
is it true that every floor pickled a pickle ?	GR
a perplexed floor kissed the president with a president on the under chief of staff !	NG
a floor in the fine sandwich .	NG
is it true that a perplexed delicious president ate a chief of staff under the delicious sandwich on a delicious president under the fine pickle in the delicious perplexed perplexed floor under a pickle under a perplexed sandwich on fine delicious perplexed sandwich under the president ?	NG
the delicious chief of staff wanted a president !	GR
every chief of staff in the president with every floor pickled wanted chief of staff .	NG
is it true that every fine perplexed perplexed pickled pickled pickle ate a president ?	GR
the fine pickled sandwich wanted the perplexed floor under the perplexed president in the pickled pickle on a fine president .	GR
is it true that a president under the sandwich ate a sandwich ?	GR
is it true that a perplexed every perplexed pickle kissed a sandwich ?	NG
a sandwich ate on floor .	NG
the fine delicious sandwich in every pickle .	NG
a sandwich with perplexed pickle ate a chief of staff .	NG
is it true that the chief of staff understood the perplexed sandwich under the delicious pickled floor under the pickled floor ?	GR
is it true that the pickled chief of staff pickled a president pickled a floor ?	NG
is it true that every chief of staff in the floor under a chief of staff under a floor ?	NG
is it true that a pickled pickle understood a chief of staff ?	GR
the fine chief of staff kissed a sandwich !	GR
the sandwich pickled the president .	GR
the chief of staff pickled a sandwich !	GR
is it true that a president in a perplexed fine fine pickle wanted the perplexed sandwich under a delicious chief of staff under every chief of staff ?	GR
a pickle on a delicious floor in pickled sandwich in a floor kissed a floor .	NG
the delicious floor understood the pickled delicious sandwich !	GR
the delicious floor on a perplexed pickled chief of staff in the president perplexed the pickle !	NG
the fine sandwich ate a pickle on a fine floor with the fine ate chief of staff .	NG
the floor fine every sandwich !	NG
a perplexed pickle kissed the delicious pickle under a pickled sandwich with a floor in the perplexed president on the sandwich the the sandwich !	NG
a fine chief of staff understood delicious chief of staff in a president on the president with a perplexed chief of staff .	NG
the sandwich pickled perplexed chief of staff !	NG
a floor kissed the delicious pickle !	GR
the fine pickle kissed a delicious pickled fine fine delicious perplexed fine chief of staff .	GR
is it true that wanted perplexed chief of staff ate the pickle ?	NG
pickled sandwich understood the president !	NG
the sandwich in a fine floor wanted the delicious floor under a pickle .	GR
the floor wanted the perplexed president .	GR
is it true that the sandwich on a chief of staff understood the perplexed sandwich ?	GR
a fine pickle wanted the delicious pickle !	GR
a sandwich in a president ate ate chief of staff !	NG
is it true that the pickle kissed a floor ?	GR
the president in a chief of staff a the president wanted the chief of staff .	NG
is it true that a sandwich pickled a fine delicious floor on the sandwich ?	GR
is it true that a floor kissed the president ?	GR
is it true that every pickle in the perplexed delicious perplexed chief of staff on a chief of staff understood every pickle ?	GR
is it true that the pickle with the delicious delicious chief of staff with a fine pickled pickled chief of staff pickled a president with a delicious pickled chief of staff under every president under a sandwich ?	GR
is it true that the pickle ate kissed pickle ?	NG
the perplexed sandwich kissed every delicious floor !	GR
every chief of staff on a perplexed perplexed pickle understood the delicious floor in with fine pickle on the delicious sandwich .	NG
the pickle understood wanted pickled president !	NG
in pickle understood a delicious president on the chief of staff on the sandwich !	NG
a sandwich kissed a floor .	GR
is it true that a floor on a delicious sandwich in the president in the president ate a sandwich ?	GR
a delicious pickled sandwich with the fine pickled delicious chief of staff wanted a sandwich !	GR
perplexed chief of staff pickled a chief of staff .	NG
a floor under a delicious president with a perplexed pickle ate the fine chief of staff .	GR
is it true that every president in delicious floor pickled the pickled pickle ?	NG
the delicious pickle kissed the the sandwich .	NG
a floor in a president under the perplexed chief of staff in the sandwich wanted a pickle !	GR
the delicious delicious floor under the sandwich with a chief of staff in a sandwich wanted a floor !	GR
every floor pickled a on sandwich !	NG
is it true that the pickle understood every president ?	GR
every perplexed president kissed a floor .	GR
the chief of staff understood every fine pickled pickle !	GR
the pickled sandwich kissed the president .	GR
is it true that every chief of staff on the sandwich ate the chief of staff ?	GR
a perplexed chief of staff kissed the fine fine perplexed delicious fine perplexed delicious sandwich !	GR
the sandwich with a pickle ate every sandwich .	GR
is it true that the president under the pickled floor under the delicious president every the pickled pickle ?	NG
a chief of staff under every floor on the sandwich in a sandwich kissed a pickle !	GR
is it true that the sandwich kissed a floor ?	GR
the perplexed perplexed sandwich kissed the pickle under a perplexed floor every the sandwich !	NG
the pickled chief of staff kissed every perplexed sandwich !	GR
pickled pickle in the floor ate the pickle .	NG
the chief of staff the the president .	NG
every pickled president in a delicious president !	NG
the perplexed delicious delicious chief of staff understood the fine perplexed president in the fine sandwich with the pickled sandwich .	GR
a president the every president .	NG
the chief of staff ate every perplexed sandwich !	GR
a floor kissed a pickle under the delicious pickle .	GR
the pickle kissed a pickled fine pickle on ate president .	NG
is it true that the president wanted ate chief of staff ?	NG
every president with a pickled perplexed president ate the pickle .	GR
the fine floor kissed every fine floor in the a chief of staff .	NG
a fine president kissed the pickle .	GR
a delicious perplexed perplexed president pickled the floor with every floor under a perplexed pickle .	GR
the perplexed perplexed chief of staff pickled with fine floor !	NG
the the sandwich pickled a president .	NG
a president understood a pickled delicious pickled president under kissed pickled fine sandwich in the floor .	NG
the fine chief of staff pickled a sandwich under the chief of staff a a sandwich .	NG
the fine president kissed a chief of staff perplexed the floor in the pickle .	NG
a fine pickle kissed perplexed president !	NG
is it true that a a delicious sandwich wanted every president ?	NG
is it true that a floor wanted a perplexed president ?	GR
the fine on pickled president ate a chief of staff !	NG
is it true that the under fine president wanted a pickled delicious fine fine sandwich ?	NG
a chief of staff understood pickled fine perplexed pickle on every perplexed floor .	NG
a sandwich ate a pickle !	GR
the chief of staff under a chief of staff wanted the sandwich with a pickle on the pickle with the ate president !	NG
every president understood a pickle !	GR
the delicious floor kissed under pickle .	NG
the delicious fine delicious president wanted every fine perplexed pickle .	GR
a chief of staff ate under sandwich .	NG
every floor in a perplexed fine floor understood the pickled pickled perplexed sandwich under wanted sandwich .	NG
a delicious president wanted a with pickled floor !	NG
the president ate under sandwich .	NG
the sandwich under the ate floor understood the perplexed sandwich on every pickle on the pickle !	NG
the pickle kissed ate delicious perplexed pickled fine chief of staff with the sandwich .	NG
the floor understood a floor !	GR
is it true that every president kissed the pickle with the president ?	GR
is it true that a floor kissed the pickle in the pickle with every pickled floor with a the chief of staff ?	NG
a pickled chief of staff pickled a chief of staff .	GR
the delicious chief of staff kissed the floor !	GR
ate chief of staff kissed the pickle .	NG
is it true that a pickle kissed the president ?	GR
a sandwich the the floor .	NG
the president understood the sandwich .	GR
a delicious pickle wanted a floor .	GR
a perplexed perplexed fine floor on the sandwich kissed the chief of staff !	GR
is it true that under perplexed sandwich kissed a perplexed pickle ?	NG
a chief of staff pickled every fine perplexed floor !	GR
the sandwich perplexed every perplexed fine delicious pickled floor understood the pickled pickled pickle !	NG
is it true that a pickled perplexed ate floor understood the chief of staff ?	NG
a president wanted a president in the pickle .	GR
a fine sandwich kissed every delicious sandwich !	GR
a chief of staff wanted the floor !	GR
a sandwich in every chief of staff on the president understood the pickled sandwich pickled a sandwich .	NG
every fine fine chief of staff pickled the floor with a pickle with the fine delicious floor in a sandwich in a pickle under the sandwich on a pickled sandwich on every pickled president with every sandwich with the delicious delicious delicious sandwich on every sandwich !	GR
the chief of staff pickled pickled chief of staff !	NG
pickled perplexed pickle wanted the delicious sandwich under a chief of staff in a perplexed president !	NG
a wanted floor ate the pickle !	NG
a pickle ate the fine president in a delicious president !	GR
the fine president kissed the pickle .	GR
a pickle ate a pickle !	GR
the floor ate with fine pickle !	NG
is it true that a president understood every under delicious delicious perplexed sandwich ?	NG
delicious pickle wanted a delicious pickled fine president .	NG
the pickled delicious ate president understood a perplexed pickle !	NG
