is it true that every pickle ate every sandwich with the sandwich ?	GR
a sandwich kissed the chief of staff .	GR
the pickled pickle understood the president .	GR
is it true that a president on the chief of staff ?	NG
the perplexed perplexed pickled sandwich a every president !	NG
a floor with a sandwich understood the sandwich .	GR
is it true that a president pickled the floor ?	GR
a fine president with the pickle understood a pickle .	GR
every pickle with a floor wanted the floor .	GR
a sandwich in a pickled fine delicious pickled fine delicious chief of staff .	NG
a perplexed president understood the floor with the pickle .	GR
a fine chief of staff a a floor wanted the pickle with every pickle !	NG
a delicious perplexed delicious fine fine pickle ate every pickle .	GR
is it true that the president under a pickle under a president kissed ate president ?	NG
kissed president understood the pickle .	NG
is it true that on chief of staff ate a chief of staff ?	NG
every under pickle ate a sandwich .	NG
is it true that the president wanted the in pickled sandwich ?	NG
is it true that the pickle the every chief of staff under a pickle understood the chief of staff ?	NG
the sandwich a the chief of staff !	NG
under perplexed pickled delicious delicious sandwich understood the floor .	NG
the president kissed fine sandwich .	NG
a president wanted every delicious floor .	GR
a pickled chief of staff understood a sandwich .	GR
the chief of staff wanted a pickle .	GR
is it true that the perplexed floor wanted the pickled fine pickle in the fine floor ?	GR
a fine president ate the floor !	GR
is it true that every understood sandwich wanted a chief of staff ?	NG
is it true that every president ate a delicious sandwich ?	GR
is it true that the pickle kissed the pickled chief of staff ?	GR
the perplexed fine pickled fine chief of staff pickled the president !	GR
a chief of staff on a sandwich on the chief of staff on a delicious president understood the delicious sandwich !	GR
the sandwich ate a floor with the the floor .	NG
is it true that a perplexed pickle wanted every pickle ?	GR
is it true that in floor understood the floor ?	NG
is it true that a floor under the delicious pickled sandwich kissed a floor ?	GR
the floor pickled a a delicious delicious sandwich .	NG
is it true that on perplexed pickle ate every floor ?	NG
delicious president understood a delicious president !	NG
every perplexed delicious pickled president understood fine chief of staff .	NG
a delicious wanted floor wanted the pickled fine delicious perplexed pickled perplexed president .	NG
a floor understood a pickle !	GR
is it true that every president understood a perplexed chief of staff ?	GR
the president in a pickle pickled a president with a sandwich in a fine floor in the sandwich .	GR
delicious president wanted the floor !	NG
is it true that the sandwich under the floor understood every president ?	GR
is it true that a fine president pickled a pickled sandwich ?	GR
under pickled president wanted a sandwich .	NG
a fine floor ate a perplexed perplexed president .	GR
is it true that wanted pickled sandwich ate the president ?	NG
a fine pickled floor in a chief of staff on a fine chief of staff with delicious pickle kissed a fine chief of staff .	NG
a pickle kissed a perplexed floor .	GR
is it true that the delicious pickle pickled a chief of staff ?	GR
perplexed pickled pickle pickled every floor !	NG
every chief of staff wanted pickled perplexed sandwich !	NG
the floor ate a fine pickle !	GR
a president on the perplexed pickled chief of staff pickled a pickle .	GR
a chief of staff wanted a president on pickled president !	NG
a pickled delicious floor kissed a sandwich with under president .	NG
the pickled fine president kissed understood pickle !	NG
a fine chief of staff pickled a perplexed delicious floor under every president with the sandwich on the president .	GR
the fine sandwich kissed every chief of staff .	GR
the delicious president a a sandwich .	NG
is it true that a sandwich understood the sandwich ?	GR
the pickle on a chief of staff with a chief of staff on the floor wanted the pickled pickled president .	GR
is it true that the perplexed sandwich on a perplexed pickle pickled a delicious delicious fine chief of staff ?	GR
the floor wanted a chief of staff !	GR
is it true that wanted delicious sandwich kissed the pickle ?	NG
a chief of staff kissed the president !	GR
is it true that every chief of staff ate fine floor ?	NG
is it true that the pickled pickled perplexed delicious president understood a president ?	GR
the floor in the fine pickle a a delicious chief of staff in the pickle under a pickle in every president !	NG
a delicious pickled chief of staff in the pickled delicious delicious pickle with the pickled pickle under the perplexed delicious sandwich on the chief of staff on a sandwich with a fine fine pickle in the perplexed pickled sandwich with a chief of staff under a sandwich in the pickled fine floor kissed a floor under a pickled perplexed floor !	GR
a sandwich wanted understood pickle in the president with every floor .	NG
every delicious sandwich on every sandwich ate the perplexed president .	GR
the president under the sandwich ate the president .	GR
a president ate every understood sandwich !	NG
a pickle with every floor ate a delicious fine pickled pickled president on pickled pickled chief of staff !	NG
a president understood a floor .	GR
a chief of staff ate the sandwich !	GR
understood sandwich kissed the perplexed perplexed delicious pickled president .	NG
a sandwich pickled a chief of staff .	GR
the floor in a fine delicious delicious sandwich with every delicious delicious pickle with a floor under understood perplexed delicious floor with a president ate the delicious floor .	NG
a floor in a president understood a chief of staff on the chief of staff under perplexed delicious fine chief of staff .	NG
is it true that a chief of staff wanted a delicious perplexed sandwich on a delicious sandwich in on fine sandwich ?	NG
ate floor pickled the sandwich in the president !	NG
a floor pickled a sandwich !	GR
the pickle pickled every pickle .	GR
every fine the fine president ate the president in a president with the delicious sandwich .	NG
is it true that a president a the sandwich ?	NG
a president under a fine floor under a floor pickled a fine fine floor .	GR
every pickle kissed the president !	GR
every sandwich pickled the floor !	GR
the president a a president .	NG
is it true that a fine chief of staff ate a floor ?	GR
a chief of staff kissed a sandwich on a pickled pickle under the chief of staff on the pickle in the president under the fine delicious chief of staff in the chief of staff on every chief of staff on a chief of staff .	GR
a delicious delicious president ate a sandwich in a fine perplexed fine pickle !	GR
ate chief of staff ate every president !	NG
is it true that every chief of staff pickled a wanted perplexed chief of staff ?	NG
is it true that every fine floor on a chief of staff kissed the fine floor ?	GR
is it true that the pickle the a pickled chief of staff ate the floor with a president ?	NG
is it true that every perplexed president understood a perplexed pickle ?	GR
the chief of staff ate on pickle !	NG
is it true that the perplexed pickled sandwich wanted a wanted chief of staff ?	NG
is it true that a pickle under the fine sandwich on the fine president in a delicious pickle understood a delicious delicious fine the sandwich under every pickle ?	NG
the pickle understood the on pickle !	NG
the pickled fine sandwich ate the delicious sandwich in the perplexed pickle in a delicious chief of staff .	GR
the pickle pickled every sandwich .	GR
is it true that kissed pickle understood every pickle ?	NG
is it true that a perplexed chief of staff understood every delicious pickled pickled floor ?	GR
the floor under every delicious president pickled a chief of staff .	GR
is it true that every delicious under floor with a perplexed pickle kissed a pickle ?	NG
every president ate a a president !	NG
the president wanted a floor !	GR
is it true that the sandwich wanted the chief of staff in the pickled pickled perplexed pickle ?	GR
is it true that every sandwich fine a chief of staff pickled every president ?	NG
perplexed sandwich kissed the president !	NG
the fine perplexed chief of staff on the sandwich on the pickled sandwich understood every pickled fine perplexed chief of staff under the president ate the pickled floor under a pickle on the fine president .	NG
is it true that a floor wanted under fine sandwich ?	NG
kissed president wanted the sandwich .	NG
the floor ate pickled floor .	NG
a president pickled fine president .	NG
the president pickled a floor !	GR
the fine chief of staff every a president wanted the president !	NG
a chief of staff ate the pickle with a fine pickle !	GR
is it true that the perplexed chief of staff understood the sandwich ?	GR
the sandwich the the president .	NG
every floor understood a chief of staff ate a delicious delicious sandwich !	NG
is it true that the pickle kissed every pickled floor ?	GR
is it true that a chief of staff with the president ?	NG
a sandwich under the sandwich .	NG
the perplexed sandwich in the perplexed fine perplexed president ate a perplexed perplexed floor !	GR
every president kissed a pickle !	GR
a pickle kissed a sandwich with the chief of staff on a chief of staff in a floor with the sandwich in a president under ate floor in a pickle .	NG
wanted sandwich understood the pickled fine pickle in a president !	NG
the president pickled every chief of staff with a chief of staff in a fine fine pickle perplexed a chief of staff !	NG
with delicious floor wanted every delicious chief of staff .	NG
is it true that delicious pickle ate every pickle ?	NG
the delicious president wanted pickled pickled pickled fine pickled chief of staff .	NG
is it true that a floor wanted a perplexed floor ?	GR
is it true that the delicious sandwich ate every president with the delicious understood delicious delicious fine floor on the delicious sandwich ?	NG
is it true that the chief of staff ate the sandwich ?	GR
every pickle wanted the delicious delicious delicious chief of staff .	GR
the sandwich understood the fine perplexed sandwich in delicious chief of staff !	NG
a perplexed under fine floor with a pickled chief of staff ate a pickled president .	NG
is it true that a chief of staff ate a pickled sandwich ?	GR
the pickle in a floor pickled a fine pickled chief of staff !	GR
the pickled delicious president pickled the sandwich .	GR
the pickle pickled a chief of staff .	GR
a president under the delicious chief of staff .	NG
the chief of staff in the perplexed perplexed president pickled the pickle .	GR
every pickle in a sandwich kissed the fine sandwich .	GR
is it true that a perplexed president under a pickle wanted a delicious sandwich ?	GR
is it true that a president pickled perplexed president ?	NG
a sandwich under a pickled floor on a chief of staff in every chief of staff with a floor kissed a president !	GR
the sandwich pickled delicious floor .	NG
is it true that a sandwich kissed the every pickle ?	NG
is it true that a chief of staff ate the perplexed perplexed delicious president ?	GR
a chief of staff ate the president !	GR
is it true that the pickled pickle on a perplexed pickle kissed the delicious sandwich ?	GR
a pickle under a pickle under every pickled delicious pickle with the sandwich kissed a fine pickled perplexed floor !	GR
is it true that the chief of staff with a floor in perplexed fine pickle understood a sandwich ?	NG
every sandwich on the pickled floor !	NG
pickled pickle on the floor understood the president !	NG
the pickled floor in the fine sandwich !	NG
a floor with a president wanted the under perplexed chief of staff !	NG
is it true that a president fine a delicious sandwich ?	NG
is it true that a sandwich with the floor on a floor understood the president ?	GR
is it true that with chief of staff on a sandwich pickled a pickle ?	NG
a delicious sandwich under pickled delicious pickled president in the pickle in the president pickled a sandwich !	NG
every sandwich wanted ate pickle .	NG
a president kissed wanted delicious delicious pickle .	NG
a delicious sandwich in a pickle !	NG
is it true that the sandwich ate a fine sandwich on the perplexed sandwich on every delicious sandwich on every floor ?	GR
is it true that on sandwich pickled the chief of staff ?	NG
a perplexed chief of staff ate the floor !	GR
the chief of staff in ate chief of staff wanted every floor !	NG
the pickle under the chief of staff ate a with fine floor !	NG
is it true that the on sandwich ate a perplexed sandwich with the chief of staff ?	NG
is it true that a president under the sandwich ate the perplexed perplexed perplexed president ?	GR
is it true that a sandwich understood the under sandwich in the chief of staff ?	NG
a president kissed the perplexed perplexed floor .	GR
a chief of staff wanted a fine sandwich .	GR
is it true that on sandwich wanted a perplexed fine president ?	NG
a pickled floor with a chief of staff with a chief of staff understood the pickle !	GR
is it true that every delicious sandwich ate a pickled floor with every pickle in the president in wanted chief of staff in a pickled perplexed fine floor with a pickle on the fine perplexed pickle on the pickled floor under a floor ?	NG
a sandwich wanted fine chief of staff .	NG
the chief of staff understood the perplexed floor !	GR
is it true that a sandwich on every chief of staff pickled ate president ?	NG
the perplexed president wanted the sandwich .	GR
every fine pickle in the floor under the pickled president ate a pickle .	GR
is it true that a pickled delicious delicious pickle wanted a sandwich ?	GR
perplexed chief of staff pickled a pickled pickle .	NG
a sandwich pickled the chief of staff on a perplexed fine fine chief of staff .	GR
a floor in a pickled chief of staff on every perplexed president with every delicious delicious pickle in the floor with every perplexed perplexed perplexed perplexed fine president on the sandwich ate the sandwich !	GR
is it true that the floor wanted a perplexed president ?	GR
the fine perplexed chief of staff wanted every chief of staff with the pickle !	GR
every a president pickled a perplexed floor .	NG
is it true that every sandwich understood the floor on a pickle in the delicious pickle under a president under a delicious president ?	GR
the floor understood a pickle perplexed a chief of staff .	NG
a floor ate the president .	GR
a floor every the pickle .	NG
is it true that a pickle in the sandwich ?	NG
every sandwich ate delicious chief of staff !	NG
the chief of staff understood the perplexed the perplexed fine pickled chief of staff !	NG
is it true that the pickle ate the pickled floor on a pickled under sandwich ?	NG
is it true that every pickled fine pickled floor pickled a pickled president ?	GR
the sandwich in the president kissed the delicious president !	GR
every floor wanted kissed president with every president !	NG
is it true that the president ate the fine wanted sandwich ?	NG
every pickle with a perplexed president pickled a floor .	GR
the chief of staff pickled the chief of staff .	GR
every chief of staff kissed a pickle in the pickle !	GR
is it true that the delicious delicious fine delicious sandwich with a delicious perplexed chief of staff in a sandwich in a pickle with the pickle understood a pickled president ?	GR
every president in the floor !	NG
is it true that the pickle every the president ?	NG
every sandwich understood a president wanted every fine fine delicious pickle .	NG
is it true that the pickle kissed every sandwich ?	GR
a chief of staff understood ate pickle .	NG
the chief of staff pickled kissed sandwich .	NG
is it true that every floor wanted the fine president under a sandwich ?	GR
the sandwich pickled the sandwich .	GR
the floor under understood president pickled the president !	NG
the president understood every pickled pickle with a delicious floor !	GR
pickled sandwich pickled every fine president .	NG
every floor wanted a pickle !	GR
is it true that the chief of staff under the president under a chief of staff with the president under a president on every chief of staff in the sandwich pickled the delicious fine perplexed pickle ?	GR
pickled chief of staff pickled a fine fine chief of staff !	NG
is it true that every fine floor pickled the president ?	GR
a floor kissed a floor .	GR
the pickle the the delicious sandwich !	NG
a chief of staff wanted a floor .	GR
the floor delicious a pickle .	NG
a perplexed pickle wanted the pickled pickled sandwich !	GR
delicious floor kissed the pickle .	NG
the pickle perplexed a floor !	NG
fine president under the fine pickle kissed a floor .	NG
a fine pickle ate a pickle .	GR
is it true that perplexed pickled chief of staff under the fine pickle with every pickled pickle under the perplexed pickled floor ate a perplexed president with a delicious chief of staff ?	NG
is it true that every floor ate a fine pickle ?	GR
a pickled delicious president in the floor under a president under the perplexed perplexed sandwich understood a delicious fine president !	GR
a sandwich understood perplexed pickle .	NG
delicious chief of staff understood a pickled president !	NG
is it true that the floor fine the pickled chief of staff ?	NG
every pickle wanted the delicious chief of staff under the chief of staff with the floor under the floor .	GR
the chief of staff wanted the fine fine pickle !	GR
the chief of staff ate a president under the fine floor .	GR
the sandwich pickled every president with with pickled delicious pickled floor !	NG
the chief of staff kissed a delicious delicious chief of staff !	GR
is it true that every floor in a fine chief of staff in a sandwich under the sandwich wanted a president ?	GR
on president on the delicious sandwich ate a president .	NG
a pickle on the perplexed understood sandwich ate the floor !	NG
the floor wanted a pickled president .	GR
the chief of staff kissed with delicious chief of staff on the sandwich .	NG
is it true that every perplexed president on the perplexed president fine every floor with every fine chief of staff ?	NG
is it true that the fine perplexed pickle in the pickle ?	NG
a floor wanted a pickle .	GR
a pickle every a pickle in the president in the perplexed perplexed delicious president in a floor !	NG
is it true that every pickle pickled the chief of staff ?	GR
a perplexed chief of staff pickled the pickled floor .	GR
is it true that a chief of staff wanted the delicious floor ?	GR
ate delicious fine chief of staff understood the pickle !	NG
a perplexed fine pickle understood a sandwich !	GR
is it true that a president understood pickled perplexed floor with a fine pickled president ?	NG
is it true that a president wanted in floor in the delicious sandwich ?	NG
every sandwich understood the pickle with the delicious pickle with the president .	GR
the fine fine a fine president kissed the fine sandwich on the chief of staff .	NG
the floor in the floor ate the sandwich .	GR
the sandwich ate a chief of staff on the floor on a delicious pickle in the pickled pickle !	GR
perplexed chief of staff kissed a chief of staff !	NG
is it true that the fine delicious chief of staff ate every president ?	GR
is it true that the perplexed pickle delicious the president ?	NG
is it true that a pickled pickle wanted every sandwich ?	GR
a floor pickled the sandwich !	GR
the pickled chief of staff the the pickle .	NG
under floor pickled the floor .	NG
a chief of staff in the pickled chief of staff pickled the sandwich .	GR
a fine president understood a president .	GR
every chief of staff wanted the chief of staff !	GR
the pickle kissed a fine perplexed sandwich .	GR
is it true that the pickled sandwich under the president in the fine delicious chief of staff in the president wanted the president ?	GR
under pickle on the pickle on a president with the pickle understood a pickle .	NG
a pickle pickled the fine sandwich with the fine perplexed floor in the floor in the perplexed pickled chief of staff .	GR
a floor ate the a fine president !	NG
a sandwich wanted a pickle ate a fine floor in the perplexed sandwich !	NG
pickled pickle on the sandwich on a perplexed chief of staff with the perplexed chief of staff understood every fine floor !	NG
the president ate the floor with every floor under a chief of staff .	GR
a sandwich kissed on president .	NG
a chief of staff ate in floor .	NG
is it true that a pickle in every pickle in a pickled sandwich under a sandwich wanted the pickle ?	GR
ate pickle ate the president .	NG
is it true that a perplexed president kissed the pickle ?	GR
the pickle pickled the perplexed floor in a delicious pickle kissed the floor .	NG
in president understood a pickle in the president !	NG
the delicious sandwich understood a floor .	GR
the president kissed fine sandwich !	NG
the perplexed sandwich understood a under delicious chief of staff .	NG
a pickled pickle understood a chief of staff under a sandwich under every president !	GR
the chief of staff ate every delicious sandwich on every floor .	GR
is it true that the pickle in every pickled chief of staff on the pickled pickle wanted wanted fine perplexed delicious floor in a sandwich ?	NG
a chief of staff wanted the pickle .	GR
is it true that a sandwich understood wanted pickled chief of staff ?	NG
the sandwich under a pickle kissed the chief of staff !	GR
every delicious president wanted the sandwich !	GR
a sandwich kissed a sandwich .	GR
every perplexed fine president ate every pickle .	GR
every sandwich wanted the chief of staff !	GR
a perplexed sandwich under the fine pickle kissed the pickle !	GR
is it true that the pickle kissed the sandwich ?	GR
is it true that a delicious president kissed with pickled pickle ?	NG
is it true that a floor understood the chief of staff under a sandwich with a floor with the fine floor on the sandwich in the floor under the pickle on a pickle under a sandwich on a pickled sandwich on a perplexed delicious president in a perplexed pickle with the sandwich on every delicious floor in a perplexed pickled pickled chief of staff on the delicious president kissed the president with a floor ?	NG
a president ate the pickle in the delicious pickle in the pickle with a delicious sandwich .	GR
every perplexed chief of staff under every sandwich with every chief of staff in the sandwich wanted on pickled delicious pickle under a chief of staff .	NG
the pickled president understood a chief of staff with a floor in a pickle pickled every president on a chief of staff !	NG
a pickled perplexed president understood with floor !	NG
fine chief of staff ate the pickle .	NG
a sandwich kissed the sandwich in a pickled pickle !	GR
with president kissed a chief of staff .	NG
a pickled pickled delicious pickle in a fine perplexed perplexed sandwich on the delicious perplexed perplexed pickled pickle wanted the fine chief of staff .	GR
is it true that the chief of staff the a president ?	NG
the sandwich in the floor under the floor with the sandwich in a perplexed floor with a fine delicious fine chief of staff wanted a pickle !	GR
is it true that a perplexed delicious sandwich under the floor on every perplexed chief of staff wanted the floor in the chief of staff under the pickle ?	GR
is it true that the floor with a perplexed perplexed delicious chief of staff understood a pickle ?	GR
every sandwich understood the pickled chief of staff .	GR
the pickled floor kissed a president with the chief of staff in the pickle .	GR
is it true that the pickled pickle ate every sandwich in the delicious president in every fine delicious floor in a perplexed delicious floor ?	GR
a fine pickled fine sandwich ate a sandwich on a chief of staff .	GR
every president pickled a chief of staff under the sandwich on a perplexed president under a floor with a president .	GR
a floor kissed the fine delicious chief of staff .	GR
a pickled delicious pickled sandwich in a pickle under a president with the delicious chief of staff pickled the floor .	GR
the pickle kissed the fine delicious delicious chief of staff .	GR
is it true that the chief of staff delicious every sandwich wanted a floor in every floor with the pickle ?	NG
a floor pickled a delicious pickle .	GR
pickled chief of staff pickled the pickle !	NG
the perplexed president ate a delicious sandwich .	GR
a chief of staff pickled the delicious sandwich in a fine floor !	GR
a chief of staff the a president in the fine pickle ate the perplexed pickle !	NG
every president the a president .	NG
the fine floor kissed pickled president under the chief of staff .	NG
is it true that the delicious sandwich delicious the sandwich ?	NG
every perplexed pickled president kissed a fine president !	GR
is it true that a delicious president under a chief of staff wanted the floor in understood chief of staff ?	NG
the president under a pickle .	NG
the president pickled in delicious pickled fine chief of staff in a floor with a sandwich with every sandwich in the chief of staff .	NG
a perplexed chief of staff kissed every perplexed sandwich under every floor !	GR
the delicious delicious pickled chief of staff ate every floor with a sandwich .	GR
is it true that the pickled on pickle ate every pickled floor with every chief of staff ?	NG
is it true that with chief of staff ate the chief of staff on the chief of staff ?	NG
perplexed floor understood the fine perplexed sandwich !	NG
a sandwich understood the chief of staff in the pickle .	GR
is it true that a president ate a pickle ?	GR
the perplexed pickled chief of staff in the chief of staff wanted a pickled sandwich !	GR
the pickled delicious delicious chief of staff understood a delicious pickled chief of staff !	GR
a perplexed delicious fine pickled chief of staff in the fine pickled chief of staff the every delicious pickle under every pickled president wanted every chief of staff !	NG
the chief of staff kissed a perplexed sandwich !	GR
a delicious floor pickled delicious pickle !	NG
the president with every delicious delicious sandwich with a pickled floor pickled under sandwich !	NG
a chief of staff on the chief of staff !	NG
is it true that perplexed fine sandwich pickled every floor ?	NG
a pickled pickle pickled the delicious pickle on a fine pickled pickled floor in a president !	GR
the sandwich kissed a sandwich in every pickled fine chief of staff in a perplexed sandwich the every delicious delicious chief of staff !	NG
is it true that the sandwich ate a sandwich ?	GR
a sandwich wanted the sandwich .	GR
the chief of staff under every pickle in the chief of staff with a pickle kissed a sandwich !	GR
a pickle kissed a chief of staff with the pickled president on every delicious delicious president with a sandwich under the chief of staff on a pickle .	GR
the chief of staff wanted a floor !	GR
a delicious chief of staff wanted the president in under pickled president !	NG
a chief of staff understood a delicious fine delicious pickled pickled pickled chief of staff !	GR
the delicious sandwich kissed the pickle !	GR
a delicious sandwich ate the chief of staff in a chief of staff on the pickle under every fine president !	GR
on delicious sandwich pickled a floor .	NG
a floor in the floor !	NG
the chief of staff understood a fine president !	GR
the pickle ate on delicious perplexed pickle .	NG
is it true that the pickle kissed perplexed fine perplexed sandwich ?	NG
the floor understood under president !	NG
the president kissed a chief of staff under a chief of staff in every perplexed floor !	GR
is it true that the pickle the the pickle pickled the floor under a chief of staff ?	NG
every floor ate in chief of staff .	NG
a sandwich understood a pickle !	GR
is it true that the pickle ate a president on fine delicious pickle ?	NG
is it true that every chief of staff a every pickle ate the pickle ?	NG
is it true that a pickled delicious floor under every sandwich ?	NG
is it true that every sandwich with a chief of staff with the pickle ate the perplexed sandwich ?	GR
is it true that the president understood a delicious pickled pickled pickled president with a pickled perplexed perplexed floor ?	GR
a fine pickle wanted a sandwich !	GR
the fine delicious pickle wanted every perplexed floor on the pickle with the sandwich !	GR
a floor fine the delicious sandwich !	NG
the pickle under a president kissed every pickle with the floor !	GR
the pickle wanted the sandwich on a pickled perplexed floor understood the pickle .	NG
a sandwich under a pickled perplexed sandwich under the president under every sandwich pickled a chief of staff with a pickled delicious president in a perplexed delicious floor on every chief of staff under the pickled perplexed delicious pickle !	GR
is it true that a chief of staff the the chief of staff on the sandwich on a president ?	NG
is it true that the president ate a perplexed sandwich ?	GR
is it true that the president kissed the sandwich under a president ?	GR
the the president pickled the floor !	NG
a pickle with every president the every chief of staff .	NG
perplexed perplexed pickle pickled a pickle .	NG
is it true that a pickle under a pickle under the floor pickled the president with the sandwich ?	GR
a delicious president under delicious chief of staff understood the chief of staff .	NG
a pickle pickled the chief of staff !	GR
a pickle understood the sandwich on a with president .	NG
is it true that under president pickled the pickle ?	NG
the sandwich kissed a fine fine floor with every delicious fine floor on kissed perplexed sandwich .	NG
the floor understood a president !	GR
the delicious chief of staff wanted the pickled pickled president !	GR
is it true that delicious pickle wanted a sandwich ?	NG
the pickled pickle with a delicious sandwich understood a sandwich .	GR
the perplexed president under a chief of staff on a pickled delicious pickle with a pickle under every sandwich understood a fine floor under every pickled delicious pickle under every sandwich !	GR
is it true that a floor wanted pickled sandwich ?	NG
the delicious floor ate pickled perplexed sandwich !	NG
ate pickled pickled sandwich wanted the delicious chief of staff under the delicious floor .	NG
fine sandwich ate a president !	NG
a president the the sandwich !	NG
is it true that every perplexed president with a delicious floor on the president under the pickle in a sandwich ?	NG
a president kissed the sandwich in every delicious fine pickle in the perplexed pickle !	GR
the pickled fine fine pickle ate a pickle under a sandwich on the sandwich in the floor with a pickled floor .	GR
a president wanted the president under the sandwich with the fine floor in the sandwich in the chief of staff .	GR
is it true that every chief of staff ate a floor under a delicious chief of staff in the pickle under the pickle on every fine fine sandwich ?	GR
a perplexed fine pickled under floor ate a pickle !	NG
is it true that delicious pickled floor wanted the fine perplexed president on a delicious delicious pickle ?	NG
is it true that the president perplexed a chief of staff kissed the floor ?	NG
is it true that every pickled president with the sandwich wanted a floor ?	GR
is it true that the floor kissed the pickle ?	GR
a chief of staff kissed a sandwich .	GR
is it true that a chief of staff with the president on a floor pickled the pickled delicious pickled delicious sandwich ?	GR
the chief of staff kissed the delicious pickle delicious a pickle with the president in the president !	NG
a pickled fine pickle kissed every fine fine chief of staff .	GR
is it true that the pickled pickled fine floor wanted pickled perplexed delicious perplexed perplexed president ?	NG
pickled sandwich pickled every president !	NG
a pickle pickled the sandwich !	GR
the on pickle pickled the pickle !	NG
a chief of staff with the pickle in a chief of staff on the president in a delicious fine delicious perplexed president in the perplexed chief of staff pickled the fine perplexed chief of staff .	GR
the fine fine floor in a under floor ate a chief of staff in a fine perplexed floor .	NG
the pickle ate pickled chief of staff .	NG
a chief of staff in the every floor pickled the pickle !	NG
a fine sandwich a every pickle !	NG
the floor with every sandwich pickled the chief of staff perplexed every perplexed president !	NG
a president the every pickled perplexed president !	NG
is it true that kissed president with every sandwich under the floor in the perplexed pickle understood the pickle under a president on a pickled floor ?	NG
the fine pickle wanted perplexed chief of staff under a pickled perplexed perplexed perplexed pickled delicious fine president .	NG
a pickle understood the sandwich .	GR
is it true that the floor wanted the perplexed sandwich ?	GR
is it true that a fine floor every a chief of staff ?	NG
every floor wanted a chief of staff .	GR
every fine pickle pickled the perplexed president .	GR
every fine president kissed every pickled fine president under the sandwich .	GR
is it true that the perplexed pickle understood a delicious pickled floor ?	GR
a pickled floor kissed every chief of staff with a pickle under a perplexed sandwich on a sandwich .	GR
wanted president understood a president .	NG
wanted floor wanted the pickle !	NG
a perplexed delicious pickled pickled perplexed floor ate a delicious pickle under every president .	GR
the president wanted every pickle !	GR
is it true that every floor ate kissed sandwich ?	NG
a floor understood the president !	GR
a fine fine sandwich pickled a delicious president !	GR
is it true that every president the a floor ?	NG
is it true that the president under a delicious pickled president with a delicious chief of staff in a chief of staff under wanted delicious delicious president pickled the president ?	NG
the floor kissed pickled perplexed chief of staff .	NG
is it true that the delicious fine pickle kissed the fine sandwich ?	GR
the delicious fine chief of staff ate the president .	GR
a pickled president under the president a a chief of staff !	NG
a sandwich kissed ate chief of staff !	NG
a delicious president the a fine pickled chief of staff on a sandwich .	NG
is it true that a perplexed under fine pickle wanted the floor ?	NG
is it true that every the chief of staff pickled a perplexed chief of staff ?	NG
the delicious president on a chief of staff pickled the sandwich !	GR
the pickled sandwich kissed the sandwich .	GR
a chief of staff pickled the delicious floor .	GR
every pickled pickle understood a president on a pickle in a president on a chief of staff .	GR
a floor ate a chief of staff .	GR
a chief of staff ate in pickle !	NG
every fine sandwich kissed every chief of staff .	GR
is it true that every floor with every floor wanted the fine fine sandwich ?	GR
a floor in the fine fine floor understood a pickle under a president .	GR
is it true that the president understood a sandwich ?	GR
is it true that a sandwich understood the floor ?	GR
is it true that the chief of staff with a president under a pickle ?	NG
a pickle under a chief of staff under a pickle on a sandwich pickled every president in kissed pickled president in a fine pickle !	NG
every sandwich understood a fine delicious floor .	GR
is it true that a chief of staff kissed the president ?	GR
is it true that a president understood a pickle delicious every pickled pickle in every pickle ?	NG
a pickle pickled a sandwich !	GR
the pickle in a fine perplexed sandwich on a pickled president ate every under sandwich in the floor .	NG
a chief of staff under the pickle ate every pickled pickle .	GR
a sandwich fine every pickled president !	NG
is it true that every president kissed fine floor ?	NG
the fine floor under a the floor pickled a sandwich .	NG
a floor a the president .	NG
a delicious fine sandwich kissed the pickle .	GR
every pickled in fine floor understood every pickle .	NG
is it true that a president on a delicious floor on the delicious on president with a chief of staff ate the pickle ?	NG
a chief of staff ate on sandwich !	NG
the pickle wanted the perplexed in sandwich on a pickle !	NG
the floor ate a pickle with every floor with on sandwich in the president !	NG
a president understood every perplexed pickled pickled delicious chief of staff .	GR
a fine sandwich wanted fine chief of staff !	NG
pickled floor ate the sandwich .	NG
the pickle kissed a pickled sandwich in the sandwich with every delicious president on the president .	GR
is it true that the fine president under the chief of staff wanted pickled president ?	NG
every perplexed floor pickled in president .	NG
the fine pickle with a chief of staff on a chief of staff kissed a a pickle .	NG
is it true that a president ate a pickled pickle ?	GR
a chief of staff ate in floor .	NG
the pickle wanted on pickled pickle under the pickled president !	NG
the president pickled the perplexed under chief of staff !	NG
a delicious sandwich understood the floor with a fine floor under a fine sandwich .	GR
is it true that every pickled president on a pickle on a president under a perplexed pickled chief of staff wanted the fine pickle ?	GR
every perplexed chief of staff pickled every president in the chief of staff .	GR
is it true that the president in a floor understood the chief of staff ?	GR
every floor ate the floor !	GR
is it true that in chief of staff understood the pickle under a chief of staff in the chief of staff ?	NG
is it true that a fine floor wanted kissed fine pickle ?	NG
the pickle under the fine chief of staff on a delicious president with the sandwich in the pickle on a president with a fine chief of staff with the fine president under the pickle under every sandwich on a fine president with the perplexed perplexed pickle in a pickle on the floor on a pickle on the sandwich under every sandwich a the sandwich under the floor .	NG
a perplexed pickle wanted the floor !	GR
the president ate a fine delicious chief of staff .	GR
a fine fine floor delicious a floor !	NG
a president ate with perplexed sandwich !	NG
every floor wanted on floor !	NG
a sandwich wanted a fine sandwich !	GR
the floor kissed a fine chief of staff !	GR
a president kissed the chief of staff .	GR
the perplexed perplexed president kissed a sandwich .	GR
is it true that pickled chief of staff ate every pickled delicious sandwich ?	NG
is it true that a pickle under a president ?	NG
a chief of staff ate the president !	GR
is it true that the president ate on sandwich ?	NG
the pickled floor pickled the delicious ate delicious delicious perplexed sandwich !	NG
is it true that the chief of staff kissed a pickled floor under the president with the sandwich on the sandwich under the pickled chief of staff under a fine sandwich on the pickled pickle under a pickled floor in the pickled fine perplexed pickle in a perplexed sandwich ?	GR
a sandwich in the delicious perplexed sandwich on the fine floor under the pickled pickle pickled a chief of staff .	GR
is it true that the president on a delicious floor under a delicious a pickle understood a sandwich ?	NG
is it true that the delicious the delicious sandwich on the sandwich understood the chief of staff ?	NG
a chief of staff under a president ate a pickled sandwich on the president under under floor under a floor on the chief of staff under a floor under a delicious chief of staff .	NG
the president understood wanted floor .	NG
a sandwich with the floor wanted the president .	GR
the chief of staff understood the chief of staff !	GR
a delicious delicious sandwich on the president under the pickle pickled the sandwich with the fine president .	GR
a pickle ate a pickle !	GR
is it true that the pickle kissed every fine fine sandwich ?	GR
a president ate a chief of staff .	GR
a a perplexed fine pickle ate a delicious fine president .	NG
the fine president kissed in pickle on the perplexed floor !	NG
perplexed pickle pickled every pickle !	NG
is it true that a chief of staff in the sandwich the a chief of staff understood the chief of staff ?	NG
a chief of staff under the floor understood the sandwich .	GR
is it true that a chief of staff in the president in a fine president ate a floor ?	GR
is it true that a perplexed sandwich with every president pickled the pickled sandwich ?	GR
the pickle pickled wanted president !	NG
pickled chief of staff wanted a president !	NG
the pickled the pickle wanted a chief of staff !	NG
a pickle wanted the delicious president with the pickle in the president !	GR
kissed fine pickled perplexed sandwich with the president wanted the floor .	NG
is it true that every fine sandwich kissed the delicious pickle ?	GR
is it true that every president wanted every fine a delicious floor ?	NG
every floor pickled the sandwich in the chief of staff with every perplexed president !	GR
wanted floor pickled a sandwich .	NG
a president understood every perplexed pickled chief of staff under in floor !	NG
is it true that a floor in every president ?	NG
a floor wanted the chief of staff on the under chief of staff .	NG
a perplexed fine pickle kissed the perplexed delicious fine chief of staff .	GR
every perplexed pickle ate the a sandwich .	NG
is it true that the pickle wanted on delicious chief of staff ?	NG
a floor ate the chief of staff in a sandwich .	GR
is it true that a chief of staff in a president in the delicious sandwich with the pickle ate a president in delicious perplexed sandwich ?	NG
is it true that a pickle ate the fine pickle ?	GR
every floor ate a perplexed floor on every chief of staff .	GR
a fine floor wanted the pickled fine pickled president with the perplexed fine president under a sandwich with a pickle .	GR
is it true that the pickle ate a president ?	GR
a floor kissed the sandwich .	GR
is it true that a chief of staff ate every fine fine delicious fine sandwich ?	GR
the floor pickled a president in every pickle .	GR
a president understood a sandwich under the delicious floor .	GR
pickled floor wanted the pickle .	NG
pickled pickle on the floor with the sandwich wanted the floor !	NG
the chief of staff under the pickled president ate the sandwich .	GR
a sandwich understood a chief of staff in a chief of staff with the chief of staff !	GR
is it true that the chief of staff kissed the president ?	GR
is it true that every delicious delicious pickled floor in a president kissed perplexed sandwich ?	NG
is it true that on chief of staff wanted a president ?	NG
the president the the president !	NG
the sandwich a a pickle with the pickle !	NG
pickled fine chief of staff understood a sandwich !	NG
a pickle under the sandwich on the delicious pickled pickle with the sandwich with under pickle wanted a pickle !	NG
a pickle pickled the pickled delicious sandwich !	GR
every floor with the floor .	NG
a sandwich wanted a fine floor !	GR
is it true that a a sandwich in a floor pickled every delicious perplexed delicious pickled pickled floor ?	NG
a floor in a chief of staff with the delicious floor .	NG
is it true that a president understood the delicious sandwich ?	GR
every floor in a pickled sandwich on the president perplexed the delicious floor understood the pickle !	NG
the president ate the perplexed pickle !	GR
is it true that the pickled floor wanted the floor ?	GR
a sandwich understood a floor .	GR
the sandwich under the pickle kissed a fine pickled floor under the fine sandwich with a chief of staff !	GR
is it true that a chief of staff wanted a delicious sandwich ?	GR
every pickled delicious fine delicious floor delicious the pickle with a fine pickle .	NG
is it true that a perplexed fine delicious sandwich with the president pickled a pickle ?	GR
is it true that a every sandwich wanted a pickled perplexed chief of staff ?	NG
with delicious pickle pickled a perplexed floor on the pickle .	NG
a chief of staff wanted a pickled wanted chief of staff !	NG
the floor ate in pickle .	NG
a pickle perplexed the fine delicious perplexed floor !	NG
is it true that the president pickled the perplexed in fine floor in a perplexed sandwich under the sandwich with a chief of staff ?	NG
is it true that a pickle on a president pickled every floor on the perplexed president ?	GR
is it true that the president the the floor ?	NG
the fine perplexed president with the pickle under a perplexed perplexed pickle ate a chief of staff in a pickle in the fine president .	GR
a pickled pickled chief of staff on every sandwich ate a pickle under a pickle .	GR
is it true that in sandwich pickled the sandwich ?	NG
is it true that the fine pickle the the pickle ?	NG
the perplexed president understood the perplexed floor !	GR
a president ate every pickled floor !	GR
is it true that every fine chief of staff kissed a delicious sandwich in the perplexed floor on the pickled fine sandwich in a floor with a president under a pickle with the sandwich under the chief of staff in the perplexed president ?	GR
is it true that the perplexed fine pickle pickled ate perplexed delicious pickle ?	NG
the president wanted in president !	NG
a president wanted every pickle .	GR
a president ate a president with a fine president with a floor !	GR
a floor in the floor under the perplexed pickled pickled pickled pickled perplexed president under the president kissed a pickled pickle !	GR
a floor wanted the every chief of staff .	NG
ate chief of staff wanted the pickle !	NG
is it true that the floor kissed the delicious perplexed floor ?	GR
a pickle ate a pickle !	GR
the sandwich the every delicious pickle on the perplexed sandwich in the pickled president under a sandwich .	NG
a chief of staff with a perplexed chief of staff ate a sandwich on a pickle with the president .	GR
a perplexed delicious delicious sandwich in the fine pickle with the chief of staff a a fine chief of staff !	NG
is it true that every pickle kissed a fine fine chief of staff ?	GR
a pickle ate on president .	NG
is it true that a pickle wanted the delicious perplexed pickle ?	GR
wanted sandwich wanted a president !	NG
a chief of staff kissed the delicious sandwich .	GR
is it true that every floor kissed a fine pickle ?	GR
the floor on a pickle understood delicious floor .	NG
every chief of staff understood a pickle !	GR
the floor fine a chief of staff .	NG
is it true that a perplexed fine perplexed chief of staff kissed the pickle ?	GR
every perplexed delicious pickle wanted the perplexed fine chief of staff !	GR
a pickled president ate pickled fine fine president !	NG
is it true that a president pickled a president under the president ate a sandwich ?	NG
is it true that a chief of staff with under sandwich wanted a pickled perplexed chief of staff ?	NG
is it true that the pickle understood with pickle ?	NG
a fine chief of staff ate a president .	GR
a delicious delicious delicious pickle perplexed a pickle pickled a pickle .	NG
is it true that a perplexed chief of staff understood a delicious pickle ?	GR
the perplexed fine delicious floor wanted a floor !	GR
the delicious wanted pickle on the delicious sandwich kissed every floor !	NG
the pickle wanted every fine the floor .	NG
is it true that a perplexed sandwich kissed a chief of staff ?	GR
the delicious pickle understood a the sandwich .	NG
a sandwich understood every president in every sandwich with the pickled sandwich on a sandwich .	GR
a pickle pickled wanted president in a chief of staff under a pickle in a chief of staff in the chief of staff on a pickle with every sandwich in the fine chief of staff !	NG
a president perplexed the president !	NG
the fine pickled floor in every delicious chief of staff under the pickle ate the floor in the floor .	GR
under delicious floor pickled a chief of staff .	NG
a perplexed sandwich understood a president .	GR
the sandwich on a floor .	NG
a pickled delicious sandwich understood the delicious sandwich !	GR
is it true that every delicious pickle ate every president under a president ?	GR
every president understood kissed pickle !	NG
a pickle wanted every floor .	GR
every floor in the floor on the perplexed delicious floor pickled every in chief of staff !	NG
a chief of staff ate the president !	GR
the kissed fine floor wanted a fine president !	NG
is it true that a floor understood a fine fine chief of staff on the delicious pickle on a fine fine chief of staff with the pickled delicious pickled pickle on a chief of staff on a delicious pickle ?	GR
a sandwich wanted on pickled pickle .	NG
the sandwich under a fine fine perplexed chief of staff wanted perplexed perplexed pickled floor !	NG
under chief of staff ate a floor .	NG
is it true that the fine pickle wanted a perplexed floor on a chief of staff wanted a pickle in a floor in the floor under a floor on a delicious sandwich under the sandwich ?	NG
the delicious pickle ate kissed perplexed president !	NG
the sandwich pickled a chief of staff !	GR
the fine chief of staff pickled every sandwich on a sandwich on the pickle !	GR
a fine chief of staff with a perplexed perplexed pickle .	NG
the in president ate a floor !	NG
delicious pickled pickle with a president kissed a perplexed floor .	NG
under pickled sandwich pickled the pickled delicious delicious chief of staff .	NG
is it true that pickled fine president under a president understood the pickle ?	NG
a the pickle kissed the floor !	NG
a delicious pickled president understood the sandwich with every sandwich under every pickle pickled the delicious floor .	NG
is it true that a floor wanted a chief of staff ?	GR
the pickle wanted the in sandwich .	NG
the pickled president pickled a pickle !	GR
a fine floor with a sandwich kissed the fine delicious pickle .	GR
a pickled chief of staff pickled a delicious delicious pickle .	GR
the chief of staff kissed a delicious perplexed sandwich on the pickle in a perplexed chief of staff .	GR
is it true that the fine delicious chief of staff kissed the floor with the president ?	GR
a pickle pickled a chief of staff .	GR
with pickled floor understood every chief of staff !	NG
every pickled floor pickled delicious pickle !	NG
is it true that the president wanted the chief of staff the the sandwich ?	NG
is it true that the floor pickled kissed perplexed sandwich in every delicious pickle under a sandwich on a fine president ?	NG
a chief of staff wanted the sandwich .	GR
the pickled pickle wanted under chief of staff under the pickled pickle .	NG
is it true that the perplexed pickled sandwich with the floor understood a perplexed perplexed pickle ?	GR
the chief of staff kissed the president .	GR
a delicious delicious chief of staff kissed the fine floor .	GR
a perplexed floor kissed the sandwich in pickled floor in a perplexed pickled floor !	NG
is it true that a chief of staff pickled a fine floor on perplexed sandwich ?	NG
the president with the floor !	NG
is it true that a pickle understood a with chief of staff ?	NG
a chief of staff understood a perplexed pickle .	GR
a floor understood a chief of staff .	GR
the pickle kissed the perplexed pickled pickle .	GR
the pickled president with the pickle in the fine perplexed chief of staff in a perplexed delicious sandwich with the perplexed floor understood pickled pickle !	NG
the delicious president understood wanted pickle !	NG
every delicious sandwich on a president under the president in every pickle in a pickle wanted every pickled president .	GR
the floor pickled kissed president with the fine perplexed delicious president with the fine perplexed delicious pickle .	NG
a the delicious floor understood a perplexed president .	NG
a president pickled every delicious floor under the perplexed pickle !	GR
is it true that the pickle kissed a pickle ?	GR
with fine floor understood every chief of staff under every floor on a sandwich .	NG
a perplexed floor in the floor under the fine pickle with the delicious president under a sandwich pickled every pickled chief of staff under pickled pickled floor with a floor .	NG
perplexed delicious perplexed sandwich understood a sandwich !	NG
in chief of staff pickled the pickle in the floor .	NG
the president under the floor under the floor pickled the floor !	GR
a sandwich pickled every sandwich !	GR
a chief of staff fine the delicious sandwich !	NG
is it true that a floor pickled the chief of staff ?	GR
the floor in the floor with a floor on the pickle on a perplexed floor kissed the perplexed perplexed floor under a pickle !	GR
is it true that kissed president ate the perplexed pickle with a chief of staff on the pickle ?	NG
a president pickled every floor .	GR
a floor wanted the floor under every chief of staff with the delicious sandwich under a sandwich .	GR
the chief of staff understood the sandwich with a fine president !	GR
a president pickled the chief of staff .	GR
a delicious president understood a sandwich !	GR
the delicious floor on every floor under the chief of staff ate every chief of staff !	GR
perplexed chief of staff pickled the sandwich !	NG
the floor understood a delicious perplexed sandwich under a pickle .	GR
the the sandwich pickled a pickled sandwich .	NG
the pickled president ate the chief of staff with under pickled pickled pickle .	NG
a chief of staff in the president ate kissed floor .	NG
every sandwich ate the president under a pickled chief of staff on every perplexed delicious president on a president under the pickled floor .	GR
every delicious fine pickled delicious fine perplexed sandwich under the perplexed delicious president on a sandwich pickled every fine pickled floor .	GR
every sandwich ate the floor !	GR
the president on a pickle wanted delicious perplexed pickle .	NG
kissed pickle in a pickle ate a pickle with the sandwich !	NG
delicious floor kissed a chief of staff .	NG
a delicious delicious pickle wanted the understood floor !	NG
understood chief of staff wanted the chief of staff !	NG
with president kissed the chief of staff !	NG
is it true that the floor under a floor kissed the sandwich ?	GR
every pickle wanted the sandwich !	GR
a fine fine pickle on every sandwich with pickled chief of staff wanted a pickle !	NG
is it true that every sandwich ate a fine perplexed chief of staff ?	GR
is it true that a delicious president understood on chief of staff ?	NG
is it true that under chief of staff wanted the president ?	NG
is it true that every chief of staff understood a pickled perplexed delicious floor ?	GR
is it true that a president under every president on in perplexed pickle wanted a perplexed perplexed floor ?	NG
every sandwich with a chief of staff wanted a on pickle .	NG
a president on the delicious fine pickle pickled the perplexed fine perplexed perplexed delicious president in the pickled fine chief of staff perplexed the president !	NG
is it true that the sandwich pickled the pickle on the floor ?	GR
is it true that a floor kissed every president ?	GR
is it true that the perplexed floor understood perplexed fine president ?	NG
the floor on the under delicious floor understood a pickle !	NG
a chief of staff the a chief of staff .	NG
is it true that the pickled sandwich kissed the delicious fine perplexed pickled floor on the pickle ?	GR
the pickle ate a president !	GR
a fine delicious president under a perplexed perplexed pickled pickle kissed the sandwich !	GR
is it true that the president with in chief of staff wanted the pickled pickled sandwich ?	NG
is it true that the floor with a floor with the sandwich wanted a delicious perplexed chief of staff ?	GR
is it true that a delicious perplexed president ate the president with the floor ?	GR
is it true that every chief of staff kissed a pickled president in a delicious president with every delicious fine sandwich under the pickled president ?	GR
a sandwich ate delicious sandwich in the pickle .	NG
the president with the chief of staff understood the perplexed pickle .	GR
a pickled chief of staff wanted the fine pickle !	GR
fine sandwich pickled the pickle !	NG
is it true that a sandwich on every fine pickle in the delicious chief of staff every the fine chief of staff in the delicious delicious floor ?	NG
a president on a pickle kissed a chief of staff !	GR
is it true that a floor on every pickle with a a perplexed sandwich wanted every chief of staff ?	NG
a sandwich pickled the kissed fine pickled pickled pickle !	NG
a pickled chief of staff pickled a sandwich .	GR
a pickle pickled a pickled chief of staff .	GR
the pickled fine chief of staff understood kissed sandwich .	NG
is it true that the pickle understood every delicious chief of staff in the perplexed a fine president ?	NG
is it true that the perplexed chief of staff kissed every chief of staff ?	GR
a pickled perplexed floor kissed every fine sandwich with the president in the delicious sandwich !	GR
every sandwich ate a perplexed perplexed chief of staff .	GR
every in president ate the delicious president !	NG
is it true that the perplexed pickle kissed a president ?	GR
is it true that the delicious floor wanted the chief of staff ?	GR
a perplexed floor kissed in sandwich !	NG
every president understood wanted floor !	NG
a president understood a delicious chief of staff !	GR
is it true that every chief of staff wanted the perplexed in chief of staff ?	NG
the perplexed perplexed chief of staff understood pickled chief of staff !	NG
the delicious fine delicious sandwich understood pickled fine sandwich .	NG
a pickled president under a floor under a president with a president under every president pickled every a fine pickle !	NG
a fine delicious fine pickle kissed delicious perplexed perplexed floor on the president under a perplexed delicious delicious fine delicious floor .	NG
a floor pickled the pickled floor !	GR
the fine perplexed pickle in a chief of staff in the delicious floor under every sandwich understood a sandwich .	GR
a pickled pickle understood the chief of staff !	GR
a chief of staff with a president under a president !	NG
the delicious fine ate fine pickle kissed the perplexed pickle with the sandwich with the perplexed pickled pickled president !	NG
every delicious fine fine floor pickled understood pickle .	NG
every president the the president !	NG
a floor kissed a president with a pickled chief of staff .	GR
understood pickle wanted a pickled fine sandwich !	NG
is it true that a fine pickled floor understood a sandwich ?	GR
is it true that ate sandwich understood the sandwich ?	NG
is it true that every perplexed president pickled the floor ?	GR
a delicious perplexed pickled chief of staff pickled the sandwich !	GR
a pickle kissed a president with the pickled pickle .	GR
the pickle understood a floor !	GR
is it true that every chief of staff kissed a perplexed floor wanted a president ?	NG
a president pickled understood pickle .	NG
a pickle pickled with president !	NG
every floor wanted the chief of staff .	GR
is it true that the on perplexed sandwich pickled a sandwich ?	NG
is it true that pickled president wanted the president ?	NG
the floor wanted the perplexed floor .	GR
a perplexed delicious pickle understood the sandwich .	GR
a fine president pickled a pickled chief of staff under the president with a pickled pickle under a pickled pickled perplexed pickled pickled floor under the floor with every chief of staff .	GR
a chief of staff understood every fine floor .	GR
the perplexed president understood a floor in every pickle on a on pickled president .	NG
the floor wanted the delicious pickle !	GR
every delicious president on the sandwich pickled every pickle on the president with every pickled chief of staff .	GR
a sandwich in in pickled perplexed president ate a perplexed delicious floor with the floor !	NG
is it true that every floor perplexed the pickle ?	NG
is it true that every floor on a chief of staff with a floor pickled the sandwich ?	GR
the perplexed perplexed pickled chief of staff pickled the president on delicious floor .	NG
is it true that the fine pickle kissed the pickled sandwich in a chief of staff ?	GR
the pickled president fine a delicious sandwich .	NG
a pickle kissed a fine delicious sandwich .	GR
is it true that delicious perplexed fine president pickled every floor ?	NG
the under floor understood the pickle .	NG
is it true that the chief of staff kissed the president ?	GR
a sandwich wanted a pickle !	GR
a perplexed floor wanted every president in fine pickled delicious pickle .	NG
a pickle under the fine delicious fine perplexed delicious chief of staff ate a president on the delicious fine chief of staff !	GR
is it true that a pickled chief of staff ate the sandwich ?	GR
the sandwich pickled the perplexed pickled floor !	GR
is it true that a fine fine delicious president on a sandwich a the pickled chief of staff on the pickle ?	NG
the pickle understood a president under perplexed delicious fine sandwich !	NG
the pickled pickle ate a floor pickled the sandwich on the chief of staff under a president .	NG
the floor ate a chief of staff under in pickle .	NG
is it true that a pickled delicious president wanted the delicious fine president in the pickled sandwich with a delicious delicious chief of staff ?	GR
is it true that a pickle with a chief of staff with the floor on the fine floor ate a sandwich ?	GR
a president on the sandwich with the floor kissed the president !	GR
is it true that a floor kissed a floor ?	GR
a pickle wanted the wanted pickled pickle !	NG
is it true that the president understood every pickled president with every chief of staff under every sandwich under the perplexed pickle ?	GR
a pickled perplexed delicious chief of staff in a sandwich wanted every pickled floor in a fine sandwich .	GR
a sandwich under a chief of staff in a pickled sandwich in a wanted perplexed delicious president kissed the sandwich .	NG
is it true that the chief of staff kissed in sandwich ?	NG
is it true that a floor understood a perplexed chief of staff with a pickled pickle with a sandwich with the sandwich on the sandwich pickled the sandwich ?	NG
is it true that every chief of staff the every pickle on every pickle in a fine delicious delicious chief of staff ?	NG
a pickle with the fine perplexed chief of staff under a pickle the the president .	NG
is it true that the chief of staff wanted a sandwich ?	GR
is it true that a president under the chief of staff ?	NG
every delicious sandwich understood the president with the under sandwich with the chief of staff !	NG
the president ate a fine floor !	GR
a pickle in the perplexed pickle .	NG
the president ate with president !	NG
is it true that the wanted pickled chief of staff pickled the pickle ?	NG
every pickled floor kissed a floor !	GR
delicious pickle kissed a pickle !	NG
is it true that the perplexed floor pickled the delicious floor ?	GR
the pickle wanted every pickle on the pickle .	GR
a floor on every pickle in fine perplexed president ate the pickled president !	NG
a chief of staff understood a floor !	GR
pickled perplexed chief of staff kissed the sandwich .	NG
fine fine chief of staff ate the pickled fine chief of staff on a floor !	NG
a floor kissed the chief of staff .	GR
the president a every president !	NG
is it true that a sandwich the every fine pickle ?	NG
is it true that a sandwich wanted the delicious pickle in every floor under a delicious chief of staff in a sandwich under the chief of staff with the pickle with the delicious president ?	GR
is it true that the sandwich in the perplexed floor ate the president with a sandwich on a floor on a sandwich ?	GR
is it true that the pickled fine sandwich in a fine delicious president with a fine chief of staff in a perplexed perplexed floor kissed the pickle ?	GR
the perplexed chief of staff under a perplexed perplexed pickled delicious floor pickled in pickled fine sandwich under every sandwich with the perplexed perplexed perplexed sandwich in every pickled floor on the president on the president with every delicious fine pickle with the delicious fine pickle under the chief of staff .	NG
a delicious pickled perplexed fine chief of staff perplexed a pickled pickled delicious president !	NG
is it true that the perplexed chief of staff wanted the chief of staff on a floor in the president in the pickled delicious sandwich on the floor ?	GR
a fine floor perplexed every chief of staff !	NG
is it true that the chief of staff pickled with chief of staff ?	NG
is it true that the sandwich wanted a fine a pickle with the pickle ?	NG
is it true that every pickle with a sandwich with a pickled president understood a perplexed floor under a floor ?	GR
every pickled sandwich understood every ate president !	NG
the delicious pickle kissed the fine pickled perplexed pickled perplexed floor .	GR
a pickled fine every sandwich on a fine sandwich ate the floor !	NG
the understood perplexed pickled pickle pickled the sandwich in the perplexed chief of staff .	NG
is it true that a floor kissed on president ?	NG
is it true that the in chief of staff ate every sandwich on a sandwich ?	NG
the chief of staff understood the pickle in the pickle on the pickle on a sandwich !	GR
every pickled chief of staff pickled the sandwich .	GR
every delicious perplexed perplexed fine president wanted a sandwich with every pickled pickled sandwich under every pickled floor with a president with the pickle with a pickle in a floor on the delicious delicious delicious fine pickled delicious president with the floor !	GR
is it true that every president kissed the chief of staff ?	GR
the sandwich wanted the perplexed president !	GR
the pickled kissed sandwich kissed a floor .	NG
a pickled president under the floor in the fine sandwich under a pickled pickle on the perplexed chief of staff with the perplexed delicious sandwich ate a chief of staff !	GR
is it true that ate perplexed pickled president ate the perplexed delicious sandwich ?	NG
a pickled on delicious fine president wanted the delicious president .	NG
kissed chief of staff pickled a perplexed floor !	NG
the president understood a chief of staff in a pickled floor under the perplexed pickle on the fine floor under the pickle on the chief of staff !	GR
every president understood the sandwich kissed a delicious chief of staff !	NG
the perplexed floor on the delicious president understood a chief of staff with the floor in the sandwich .	GR
a pickle kissed the delicious delicious floor !	GR
perplexed president ate a pickled floor !	NG
a fine floor wanted the perplexed perplexed sandwich in a president .	GR
wanted president ate a delicious president !	NG
the fine fine pickled sandwich ate the delicious sandwich .	GR
the floor kissed the pickled president .	GR
the pickle kissed a fine chief of staff under the sandwich !	GR
the sandwich understood the sandwich !	GR
a sandwich pickled the pickle !	GR
a fine chief of staff in a sandwich understood a pickle on every delicious perplexed chief of staff on the chief of staff !	GR
every sandwich fine a chief of staff ate a president !	NG
wanted delicious president ate a delicious president .	NG
every pickle kissed every pickled sandwich !	GR
every perplexed sandwich ate the delicious the floor !	NG
every chief of staff under the pickle understood under pickle !	NG
is it true that the delicious sandwich on every sandwich wanted every sandwich ?	GR
a chief of staff with the perplexed president in a president with every floor understood delicious chief of staff on every floor !	NG
the president kissed a president !	GR
is it true that every sandwich kissed the sandwich ?	GR
a pickle understood the pickled sandwich !	GR
the delicious president understood pickled delicious floor with a floor under every fine floor !	NG
a perplexed fine chief of staff understood a floor in every chief of staff .	GR
a president ate every chief of staff .	GR
every floor understood a president under a president !	GR
the pickle pickled ate floor .	NG
is it true that the pickled chief of staff kissed a chief of staff ?	GR
the perplexed chief of staff ate understood president under a pickle with a chief of staff .	NG
is it true that the delicious sandwich pickled perplexed sandwich ?	NG
a sandwich understood the chief of staff pickled a pickled fine sandwich under a sandwich with a chief of staff .	NG
the floor understood the perplexed sandwich .	GR
every sandwich on the floor understood a delicious sandwich .	GR
a fine sandwich under the pickle ate a delicious pickled floor under a pickled fine president under the pickled sandwich on the chief of staff under every chief of staff on a fine fine fine fine perplexed sandwich with a chief of staff on a sandwich with a chief of staff with a floor under every pickle !	GR
is it true that a sandwich pickled the perplexed delicious chief of staff in the sandwich under the sandwich with every fine sandwich ?	GR
the chief of staff under a fine fine floor with a fine president kissed the fine chief of staff !	GR
is it true that under fine president on a floor wanted a perplexed pickle ?	NG
the pickle pickled a in pickle .	NG
a chief of staff under a floor understood perplexed sandwich !	NG
a pickled floor ate the fine chief of staff !	GR
the chief of staff with a chief of staff .	NG
the delicious delicious pickle pickled a pickled sandwich with a delicious pickled floor !	GR
is it true that a pickle pickled fine president ?	NG
is it true that a sandwich on a fine sandwich with the pickle wanted a sandwich under every perplexed chief of staff under a floor ?	GR
is it true that pickled sandwich pickled the fine pickle with every fine pickle ?	NG
is it true that every president in every president wanted the floor kissed the chief of staff with a chief of staff ?	NG
is it true that a chief of staff understood every delicious sandwich ?	GR
is it true that the sandwich on the delicious sandwich ?	NG
the floor in the chief of staff !	NG
is it true that the floor kissed perplexed president ?	NG
is it true that a president kissed the sandwich ?	GR
a perplexed pickle pickled the delicious chief of staff !	GR
is it true that under sandwich ate a president ?	NG
is it true that a floor ate a sandwich in a president on a sandwich ?	GR
the pickled pickle wanted pickled fine floor in a floor !	NG
is it true that a pickled floor in a chief of staff in a sandwich wanted the fine sandwich ?	GR
the fine sandwich fine every delicious president .	NG
the delicious perplexed president kissed fine floor !	NG
is it true that the floor every the fine pickle understood a floor ?	NG
the kissed floor kissed a floor !	NG
a perplexed president ate ate fine sandwich with a delicious pickle under a pickle .	NG
every fine delicious floor wanted the fine fine president under a sandwich under a floor !	GR
every president in the sandwich ate a pickle !	GR
a floor in a pickled president .	NG
the president the a pickled sandwich !	NG
is it true that a sandwich under a fine chief of staff with a pickle in the floor understood a fine perplexed delicious pickle on the delicious president under a president ?	GR
every pickled president pickled a floor !	GR
a pickle a the floor !	NG
a pickle on every chief of staff in every sandwich with the chief of staff with understood president on the fine sandwich under the delicious fine chief of staff with a floor ate the perplexed president under a fine fine chief of staff !	NG
is it true that the pickle in every delicious chief of staff ate the president in every perplexed pickle ?	GR
is it true that a chief of staff perplexed the pickled pickle ?	NG
is it true that the pickle understood the president under every delicious perplexed president ?	GR
is it true that a sandwich wanted in pickled delicious pickle ?	NG
a pickle understood the pickle .	GR
is it true that the chief of staff on every floor understood a pickled chief of staff in the perplexed sandwich under a president with a pickle ?	GR
the floor in the president understood a with chief of staff !	NG
is it true that a fine pickle pickled a pickled floor the the sandwich ?	NG
with president ate the floor with a president .	NG
is it true that the pickle on a sandwich with the chief of staff wanted pickled floor under the pickled fine fine pickled president under a president ?	NG
every pickled president perplexed the perplexed pickle ate a floor !	NG
is it true that the delicious floor understood a chief of staff ?	GR
is it true that the floor every the president ?	NG
every president kissed with floor !	NG
is it true that every pickled pickled chief of staff kissed every chief of staff ?	GR
a fine chief of staff under a president with the president with the sandwich kissed a perplexed sandwich !	GR
is it true that a pickle in the fine pickled delicious delicious pickled pickled sandwich kissed pickled president under a pickle under the perplexed pickled president with every delicious pickle ?	NG
a president understood a floor !	GR
pickled floor wanted a sandwich .	NG
a chief of staff the the floor under the pickle .	NG
is it true that the pickled president ate a perplexed pickle ?	GR
is it true that a pickled fine sandwich with a floor on every sandwich with a president in every sandwich under the fine president with the fine pickle in the chief of staff under the sandwich on a president kissed every perplexed sandwich on the perplexed chief of staff ?	GR
the delicious sandwich under every fine sandwich with the floor in a delicious pickle in the fine sandwich under a fine president wanted the president .	GR
is it true that a pickle ate a chief of staff ?	GR
is it true that a pickled floor kissed a chief of staff ?	GR
is it true that the president wanted a pickle under a pickle ?	GR
in sandwich pickled a delicious sandwich .	NG
a sandwich ate under floor !	NG
is it true that a fine pickled perplexed perplexed chief of staff ate a chief of staff ?	GR
pickled perplexed chief of staff kissed the floor .	NG
is it true that the sandwich pickled the perplexed perplexed floor ?	GR
is it true that a pickled sandwich ate every president ?	GR
a pickle on a pickle in every floor in the floor in a chief of staff under the sandwich on every pickle on a perplexed delicious chief of staff ate the delicious fine sandwich with the floor .	GR
the president with a sandwich !	NG
is it true that a fine pickle wanted the sandwich ?	GR
the fine pickled sandwich in the sandwich pickled every pickle !	GR
the president understood ate floor .	NG
the sandwich understood a president .	GR
a chief of staff in a perplexed sandwich with the chief of staff under every pickled fine fine delicious fine pickled pickled pickled president understood the sandwich under the floor understood the pickle in a president with every pickled pickle on the delicious pickle on the pickle !	NG
every pickle wanted the president .	GR
the chief of staff kissed the delicious pickled pickle .	GR
a floor understood a delicious pickled pickle .	GR
a floor understood a delicious pickle .	GR
a delicious perplexed fine perplexed floor understood every delicious chief of staff in a perplexed delicious chief of staff !	GR
a president with the pickled fine delicious sandwich on the perplexed chief of staff in a chief of staff understood the floor !	GR
every pickle with a floor on a fine fine president with the understood floor kissed the fine floor !	NG
a fine pickle wanted every perplexed sandwich under the floor in a pickle with a chief of staff under a floor under a pickled sandwich with the chief of staff under a fine fine president in a president with a chief of staff with every sandwich !	GR
every delicious pickled pickle under kissed floor wanted a pickled pickled delicious floor !	NG
under pickle wanted the chief of staff !	NG
is it true that a pickle in a perplexed perplexed chief of staff with a delicious sandwich ?	NG
the pickled president pickled the ate pickle .	NG
is it true that the president kissed the president under the in delicious sandwich on a president ?	NG
is it true that the sandwich understood a chief of staff the the chief of staff under the pickle on a sandwich in a perplexed floor ?	NG
a chief of staff pickled every chief of staff under every perplexed perplexed sandwich !	GR
a delicious pickle pickled a pickled pickled president in every floor with the floor with the perplexed pickle .	GR
every delicious floor under a chief of staff with a pickle on a delicious fine president in with pickle pickled every pickle !	NG
the president understood a pickled a sandwich .	NG
a delicious floor in a on fine president ate a president !	NG
with perplexed president understood every sandwich on the perplexed president !	NG
the floor ate with fine floor .	NG
is it true that pickled president pickled the pickled pickled delicious sandwich ?	NG
is it true that pickled pickled sandwich ate a president ?	NG
is it true that every perplexed floor understood on floor ?	NG
a pickle kissed every fine perplexed floor .	GR
a pickle understood kissed pickle .	NG
a the president understood a pickle !	NG
the pickled floor under the chief of staff in the floor with a delicious president understood the fine president .	GR
a sandwich wanted a pickled perplexed pickle .	GR
every sandwich in every president in the fine president under the sandwich with the sandwich on a pickle on the sandwich with every delicious pickle ate a perplexed pickle !	GR
a floor pickled every pickle !	GR
is it true that the pickle understood with pickle ?	NG
is it true that every president ate perplexed delicious president ?	NG
is it true that a pickle under the fine perplexed sandwich with the sandwich under a floor with the pickle in a delicious floor wanted a floor ?	GR
under president pickled a president !	NG
the president kissed every chief of staff with the fine chief of staff !	GR
ate perplexed floor on a floor ate a floor !	NG
a fine delicious president in the delicious fine president understood the perplexed floor !	GR
the sandwich a a chief of staff in every perplexed pickle in the president with the sandwich .	NG
delicious chief of staff understood a pickled perplexed president .	NG
a delicious sandwich wanted every fine fine sandwich .	GR
the pickled pickle a the sandwich on the sandwich .	NG
is it true that the delicious floor understood a president with the fine pickle under a fine the perplexed sandwich ?	NG
a pickle ate the fine chief of staff .	GR
is it true that a perplexed sandwich understood the chief of staff in a delicious pickle ?	GR
is it true that every chief of staff the the sandwich ate the pickled pickled fine chief of staff ?	NG
a sandwich ate a with president .	NG
is it true that a perplexed delicious pickle fine every chief of staff ?	NG
pickled delicious floor kissed the president .	NG
a president in the pickled president on every delicious floor kissed a the sandwich !	NG
is it true that a perplexed president pickled a floor ?	GR
the president understood a chief of staff in every perplexed president .	GR
a a floor wanted the president !	NG
is it true that the floor on the kissed pickled chief of staff kissed a chief of staff ?	NG
every president understood fine floor .	NG
pickled president understood the pickled chief of staff !	NG
a chief of staff in the pickled sandwich under a fine pickled sandwich pickled the president .	GR
is it true that on delicious president ate the president ?	NG
is it true that a sandwich ate the president ?	GR
the chief of staff understood a fine sandwich !	GR
every perplexed delicious floor understood the chief of staff !	GR
a floor delicious every perplexed president on every chief of staff .	NG
the pickle on a sandwich perplexed a sandwich on the sandwich on a sandwich wanted a pickle .	NG
the sandwich every a president with the sandwich !	NG
a fine pickled sandwich kissed every pickle !	GR
a perplexed pickle kissed understood pickle !	NG
a fine floor a the president .	NG
the president on a pickle wanted the perplexed pickle .	GR
is it true that the floor wanted the fine pickled in pickled pickled sandwich ?	NG
is it true that every sandwich understood a fine fine chief of staff with a perplexed floor ?	GR
is it true that a floor kissed in president ?	NG
a sandwich kissed the pickled floor .	GR
a perplexed pickle under the floor in a perplexed sandwich .	NG
is it true that a president kissed a delicious a sandwich ?	NG
every a sandwich kissed a floor .	NG
the pickle kissed a president !	GR
the perplexed pickle every a floor !	NG
is it true that the sandwich ate a sandwich ?	GR
under sandwich under a sandwich pickled a chief of staff !	NG
a sandwich wanted every delicious sandwich !	GR
is it true that the chief of staff wanted a chief of staff ?	GR
a president wanted under pickled perplexed chief of staff .	NG
every the sandwich understood the president .	NG
a fine fine floor wanted delicious pickle .	NG
a sandwich ate ate sandwich !	NG
the pickle wanted every perplexed chief of staff !	GR
is it true that fine floor kissed the delicious perplexed sandwich ?	NG
a sandwich under on pickle kissed a floor !	NG
is it true that a pickle kissed every delicious delicious pickle on a floor under pickled delicious fine perplexed president ?	NG
every chief of staff delicious the sandwich .	NG
a perplexed sandwich pickled a sandwich .	GR
a president understood the president .	GR
a delicious president ate the sandwich with a delicious perplexed pickled pickle .	GR
is it true that a delicious pickle in the delicious pickle wanted a floor ?	GR
is it true that the delicious president with the pickled pickled chief of staff with the sandwich on a chief of staff with a floor ate a perplexed chief of staff ?	GR
is it true that a pickled perplexed sandwich understood a floor ?	GR
a chief of staff with every fine chief of staff wanted the perplexed pickled pickle !	GR
the floor delicious the chief of staff .	NG
in floor kissed the pickled chief of staff !	NG
is it true that the pickled chief of staff pickled the president ?	GR
the sandwich ate a sandwich on pickled chief of staff .	NG
a pickled floor pickled a sandwich in with pickled pickled sandwich on a floor .	NG
a in president ate the pickle !	NG
a pickled ate pickle understood a pickle .	NG
is it true that a sandwich wanted a pickled perplexed chief of staff ?	GR
kissed sandwich with every president pickled every sandwich .	NG
is it true that perplexed floor kissed a president in a pickle ?	NG
a fine perplexed pickle ate the the delicious chief of staff .	NG
every pickle the a fine floor .	NG
the floor pickled the president on the pickled pickle on a president under ate chief of staff under a sandwich in the chief of staff !	NG
is it true that the fine president under a chief of staff in every chief of staff understood a perplexed chief of staff ?	GR
every sandwich ate the sandwich .	GR
understood president pickled a delicious president !	NG
pickled chief of staff ate every pickled sandwich !	NG
is it true that a pickled pickle pickled a delicious floor ?	GR
a fine chief of staff every a chief of staff .	NG
is it true that a delicious chief of staff under on sandwich pickled the fine pickle ?	NG
the pickle ate the floor in every pickled pickle on in sandwich in a perplexed president !	NG
the sandwich understood the sandwich in a president with a president .	GR
a floor kissed with pickle with every pickle !	NG
the delicious chief of staff on with fine delicious perplexed pickled chief of staff pickled the delicious pickle .	NG
is it true that a chief of staff pickled the sandwich with the sandwich in the pickle under the perplexed pickle ?	GR
every pickled the chief of staff wanted a president .	NG
is it true that every pickle kissed a perplexed fine sandwich ?	GR
is it true that the sandwich on the president ate on pickle ?	NG
the perplexed kissed chief of staff wanted the president .	NG
a pickled sandwich wanted in fine delicious floor under a president .	NG
a fine president pickled a perplexed president on a fine floor !	GR
every floor understood in sandwich !	NG
the president pickled a perplexed fine chief of staff in a chief of staff under the pickled pickle in a fine delicious pickled pickle on the pickle on a president under the sandwich .	GR
the floor understood a delicious pickle with every sandwich .	GR
a the chief of staff understood the sandwich with a fine fine fine pickle !	NG
is it true that every sandwich with under sandwich understood a perplexed pickle in a chief of staff in the fine floor ?	NG
is it true that fine president pickled the fine perplexed fine sandwich ?	NG
delicious delicious president ate a pickle !	NG
the president pickled a perplexed president !	GR
the with delicious chief of staff ate a pickled pickle .	NG
the delicious chief of staff pickled the fine president .	GR
pickled floor pickled every delicious sandwich .	NG
kissed sandwich kissed the delicious perplexed sandwich .	NG
a president wanted pickled perplexed pickle !	NG
the pickle kissed a perplexed perplexed chief of staff !	GR
is it true that a president pickled with chief of staff ?	NG
the fine fine chief of staff ate the chief of staff in understood sandwich !	NG
pickled sandwich ate a pickle !	NG
wanted president in the chief of staff ate a chief of staff with the pickle .	NG
the pickle fine every pickled sandwich on a president with a floor .	NG
a president pickled the the chief of staff .	NG
every sandwich pickled a a fine president !	NG
the sandwich pickled a delicious perplexed fine floor under a delicious delicious pickle .	GR
is it true that the chief of staff pickled a fine pickle ?	GR
is it true that perplexed delicious floor understood the pickle ?	NG
a floor wanted a sandwich !	GR
is it true that the chief of staff pickled the chief of staff under a president with the president under the pickle on a fine sandwich in a perplexed delicious floor on a perplexed chief of staff on a on fine pickle ?	NG
the pickled delicious on chief of staff understood the perplexed fine delicious president .	NG
a fine pickle on a chief of staff !	NG
is it true that the perplexed sandwich understood the perplexed chief of staff with a president in the chief of staff in the pickle on a chief of staff on a perplexed president under the chief of staff with a president ?	GR
is it true that with pickled pickled sandwich kissed the pickle ?	NG
every president with a perplexed sandwich on every pickled pickled perplexed floor wanted every chief of staff ate a chief of staff .	NG
a pickled perplexed president kissed the sandwich with the fine floor under a president under every pickle .	GR
a floor kissed every sandwich !	GR
every sandwich understood the pickled pickle .	GR
a delicious sandwich kissed a perplexed sandwich in every sandwich .	GR
understood fine president kissed the pickle .	NG
the fine floor pickled the delicious perplexed fine pickle .	GR
the floor on the perplexed sandwich !	NG
a delicious chief of staff understood a pickled chief of staff pickled every floor under every president under every chief of staff with the president .	NG
a floor kissed a pickled pickled delicious floor .	GR
a president in a floor understood a perplexed perplexed delicious delicious floor !	GR
is it true that every fine chief of staff understood every pickle ?	GR
is it true that the fine delicious pickle pickled a chief of staff ?	GR
every pickle ate the sandwich .	GR
every sandwich ate a floor pickled the perplexed chief of staff under every floor .	NG
is it true that a fine pickle delicious every sandwich ?	NG
is it true that every floor wanted the wanted pickle ?	NG
a delicious perplexed floor understood the perplexed chief of staff .	GR
every perplexed pickle wanted a sandwich under a president !	GR
under floor kissed a chief of staff .	NG
every pickled chief of staff wanted the perplexed pickle .	GR
a floor with the chief of staff wanted pickled president .	NG
a delicious president wanted the floor !	GR
a president delicious the sandwich !	NG
is it true that the sandwich understood delicious sandwich ?	NG
is it true that pickled chief of staff wanted every chief of staff ?	NG
a floor understood the perplexed floor !	GR
a delicious chief of staff wanted a perplexed delicious the president .	NG
on sandwich pickled every perplexed chief of staff .	NG
the floor on the pickle under the delicious pickle in the pickle every the sandwich under a pickle wanted a sandwich !	NG
is it true that the pickled pickled perplexed pickled floor wanted every chief of staff ?	GR
is it true that every delicious chief of staff understood a chief of staff ?	GR
is it true that the perplexed sandwich kissed every floor ?	GR
the pickle ate every fine perplexed floor !	GR
is it true that the chief of staff kissed the pickle ?	GR
the fine floor wanted the president in the floor !	GR
a pickle on a pickled on sandwich wanted the president in the pickle .	NG
a fine pickled delicious pickled sandwich ate the sandwich !	GR
a floor delicious a pickle .	NG
every president wanted a pickled sandwich !	GR
the president ate pickled president !	NG
the chief of staff with a fine delicious delicious president on every delicious perplexed chief of staff understood a every sandwich in a sandwich !	NG
a delicious chief of staff pickled a floor !	GR
the pickled floor pickled the fine chief of staff .	GR
ate pickled floor kissed a chief of staff !	NG
the floor ate the president .	GR
is it true that a fine delicious sandwich understood the delicious delicious kissed delicious delicious perplexed perplexed delicious perplexed chief of staff ?	NG
a pickle understood the sandwich .	GR
is it true that a floor wanted the sandwich ?	GR
a pickle ate a president !	GR
every floor under the chief of staff understood a floor .	GR
is it true that the chief of staff understood delicious floor ?	NG
is it true that a pickle under the chief of staff with a floor wanted the sandwich ?	GR
a president under the delicious chief of staff in a delicious pickled chief of staff under a chief of staff wanted the fine floor .	GR
a chief of staff wanted a pickled pickle with the president .	GR
is it true that a pickle in every sandwich kissed every sandwich ?	GR
the fine wanted president understood the fine delicious pickle !	NG
is it true that a chief of staff on a floor with a pickle ?	NG
a president kissed every delicious sandwich on the pickle with the president .	GR
a chief of staff on a sandwich with the the pickled floor wanted a pickle .	NG
the president wanted under floor !	NG
the perplexed pickle kissed a president with the president !	GR
a pickle wanted a fine floor with the floor on fine fine chief of staff !	NG
a sandwich in a pickle on a president understood the floor .	GR
is it true that the under fine chief of staff pickled a president ?	NG
is it true that a floor with the chief of staff in the chief of staff wanted the sandwich ?	GR
is it true that a pickled sandwich kissed a fine sandwich ?	GR
a pickled perplexed under delicious fine sandwich wanted the floor !	NG
the fine perplexed pickle kissed a floor !	GR
a chief of staff ate the delicious chief of staff !	GR
is it true that the delicious delicious floor on a delicious sandwich on a pickle in every fine perplexed perplexed pickled pickle ?	NG
a delicious delicious perplexed pickle pickled the delicious pickle !	GR
a chief of staff ate a floor on a president .	GR
is it true that perplexed chief of staff understood the perplexed fine fine chief of staff under every fine floor ?	NG
the floor on a floor .	NG
a sandwich under the delicious delicious delicious chief of staff pickled the floor !	GR
is it true that a chief of staff a the president ?	NG
a floor in a pickled sandwich ate a sandwich .	GR
is it true that a pickle ate the perplexed sandwich ?	GR
is it true that the floor in a chief of staff in a president understood the president with every pickled perplexed president ?	GR
a pickle kissed the fine sandwich !	GR
a a chief of staff wanted the pickled chief of staff .	NG
is it true that a chief of staff kissed the sandwich ?	GR
the chief of staff under the fine pickle under every sandwich wanted the president .	GR
the pickled pickled perplexed chief of staff understood the floor !	GR
the pickled pickled floor wanted the a fine president .	NG
is it true that a with fine president pickled the delicious sandwich ?	NG
every sandwich a every chief of staff !	NG
a the perplexed delicious chief of staff understood a fine pickle with every delicious sandwich under the president .	NG
a chief of staff wanted the fine the floor !	NG
a chief of staff understood the president !	GR
is it true that the chief of staff with the pickle wanted a pickled fine delicious perplexed sandwich ?	GR
is it true that a delicious pickled pickled floor ate a delicious pickled sandwich under every floor on a president under a perplexed pickled delicious president ?	GR
is it true that the pickled fine president on the president kissed fine president ?	NG
is it true that a chief of staff wanted a floor ?	GR
the perplexed fine floor kissed the sandwich !	GR
a sandwich with a fine kissed president under a perplexed pickle on every delicious chief of staff wanted a president .	NG
is it true that a sandwich ate every a perplexed pickle ?	NG
a floor pickled every on president with the pickle under a floor .	NG
a floor in the floor on a sandwich wanted the perplexed pickled delicious pickle !	GR
delicious president kissed the chief of staff !	NG
is it true that a president pickled the president in a delicious perplexed pickle in the delicious fine floor ?	GR
the sandwich ate a floor .	GR
a pickle under a chief of staff on the floor understood understood pickle !	NG
is it true that every president pickled the chief of staff ?	GR
every sandwich with the floor under the pickle !	NG
on sandwich pickled the floor !	NG
wanted president understood the fine perplexed perplexed fine president .	NG
a president on the perplexed perplexed chief of staff pickled a sandwich under the chief of staff in the president .	GR
a delicious pickle kissed the pickle !	GR
the floor kissed kissed pickle .	NG
is it true that every floor pickled a in floor ?	NG
a president kissed the perplexed pickled president !	GR
is it true that a sandwich kissed the pickle ?	GR
a chief of staff understood the pickle with the delicious president with the chief of staff with a sandwich with the pickle with every chief of staff .	GR
under perplexed pickled president pickled a president .	NG
a pickle with a fine floor under a sandwich pickled the floor .	GR
the sandwich ate a perplexed fine president !	GR
a fine sandwich understood wanted sandwich under a floor with a floor .	NG
the fine perplexed pickled president ate a on delicious chief of staff !	NG
the sandwich ate with sandwich under the sandwich !	NG
the president kissed the fine sandwich .	GR
on floor pickled a pickle .	NG
is it true that a pickled perplexed delicious pickled fine delicious floor pickled every pickled president ?	GR
is it true that a chief of staff under every floor ?	NG
the chief of staff understood pickled president .	NG
a president in a chief of staff in every president understood a sandwich on the president .	GR
every sandwich understood the perplexed perplexed chief of staff under under pickle !	NG
every sandwich understood a chief of staff .	GR
a pickled perplexed delicious pickled delicious fine perplexed sandwich ate kissed sandwich under the pickled floor .	NG
every on pickled floor under every perplexed sandwich wanted a president .	NG
is it true that a delicious fine pickled perplexed delicious pickle under the delicious floor ate a chief of staff ?	GR
the sandwich in the pickle wanted a pickle with a sandwich on the president .	GR
is it true that the chief of staff wanted a pickle ?	GR
a sandwich wanted the sandwich !	GR
the pickle every the perplexed president .	NG
is it true that a floor with a delicious pickle wanted the floor with the pickle ?	GR
under chief of staff wanted the floor .	NG
is it true that every president a the sandwich ?	NG
the fine perplexed sandwich wanted ate chief of staff !	NG
the pickle ate the chief of staff .	GR
the pickled chief of staff in the chief of staff !	NG
the pickled pickled president wanted the delicious chief of staff .	GR
a pickled pickle wanted a with president with the pickle under the sandwich !	NG
the pickled with president kissed a pickle with a delicious chief of staff with a perplexed sandwich .	NG
is it true that the sandwich in a floor understood the sandwich under a pickle on the fine president ?	GR
a president understood a floor !	GR
every perplexed chief of staff a a president !	NG
is it true that a chief of staff with the president ?	NG
is it true that a floor in a fine fine sandwich on the chief of staff on the perplexed perplexed fine pickle on the delicious floor ate every perplexed chief of staff in the pickled president under a president under a sandwich ?	GR
is it true that a pickled the delicious sandwich understood a fine pickle with every floor ?	NG
a president kissed the sandwich pickled the fine sandwich in every pickle under every president on every perplexed floor under every president on a chief of staff with the floor under a floor .	NG
delicious chief of staff wanted every sandwich .	NG
is it true that on sandwich ate the pickle ?	NG
every sandwich ate a pickle .	GR
a delicious delicious president wanted the chief of staff .	GR
a floor in a pickle kissed a delicious perplexed sandwich .	GR
a sandwich delicious the delicious floor understood a sandwich .	NG
is it true that a pickle delicious the fine pickle ?	NG
the floor under the perplexed chief of staff pickled the pickled perplexed pickled pickled president .	GR
the pickled pickle wanted a chief of staff on a chief of staff .	GR
a delicious fine floor pickled the perplexed sandwich in a fine a floor !	NG
is it true that a sandwich kissed a chief of staff ?	GR
is it true that every pickled floor in a president understood a delicious chief of staff ?	GR
is it true that the sandwich the a floor ?	NG
is it true that a pickled sandwich kissed every delicious floor ?	GR
every understood pickle ate every floor !	NG
the fine perplexed fine pickle under the sandwich with the president kissed a delicious floor with every delicious perplexed delicious president with every pickled sandwich understood a pickle on a floor !	NG
the pickle wanted the delicious delicious floor !	GR
is it true that the perplexed delicious pickled chief of staff pickled understood floor ?	NG
is it true that understood sandwich ate the chief of staff ?	NG
is it true that a perplexed pickle understood the pickle in every pickled sandwich on every fine president with every delicious president on a fine floor with a fine president ?	GR
a pickle ate kissed perplexed chief of staff !	NG
the chief of staff kissed a delicious pickle on a sandwich .	GR
the pickle with the perplexed pickle !	NG
a sandwich on pickled fine perplexed perplexed president kissed a president !	NG
a sandwich in every pickle with on pickle ate the president .	NG
the chief of staff on every floor understood a pickle .	GR
the chief of staff kissed a pickle .	GR
every pickle ate the president on the pickled pickle on the perplexed sandwich with the floor on a president with the fine chief of staff with the floor on a delicious fine pickle with a perplexed sandwich under the pickled sandwich under a pickle under a pickled pickle on the delicious pickled floor !	GR
a perplexed chief of staff in the fine floor with the floor in the delicious chief of staff kissed the fine delicious fine delicious fine pickle .	GR
is it true that the floor with the delicious chief of staff understood a sandwich ?	GR
the delicious perplexed in perplexed perplexed floor pickled a pickle !	NG
is it true that every fine president understood a president ?	GR
is it true that every fine president wanted a delicious delicious chief of staff ?	GR
every president kissed a pickle with a delicious pickle !	GR
a fine fine president kissed the president with the sandwich !	GR
kissed president kissed the president !	NG
is it true that every perplexed pickled pickle pickled a delicious fine sandwich on ate floor ?	NG
a chief of staff wanted a president .	GR
the chief of staff ate understood president under the fine floor .	NG
a pickled delicious on pickle wanted the fine pickled pickle with the chief of staff .	NG
every chief of staff pickled every every chief of staff with the fine floor !	NG
is it true that every pickle wanted a floor under a floor in a chief of staff with perplexed president ?	NG
is it true that the pickled fine delicious delicious fine delicious chief of staff with the delicious pickled chief of staff with every sandwich with the perplexed pickle with a fine sandwich in the president under a floor under every sandwich kissed the sandwich ?	GR
is it true that the perplexed delicious fine perplexed in chief of staff wanted a floor ?	NG
pickled delicious sandwich ate a pickled delicious sandwich !	NG
with perplexed floor kissed a sandwich .	NG
the sandwich on every floor pickled a chief of staff .	GR
a sandwich understood a sandwich !	GR
is it true that a floor with a pickle wanted the delicious delicious pickled pickled perplexed chief of staff ?	GR
the sandwich kissed every a chief of staff under a sandwich under every pickle !	NG
is it true that a perplexed sandwich kissed a perplexed perplexed chief of staff under a pickled delicious perplexed pickled pickle ?	GR
is it true that the fine president with a sandwich with the floor in a floor in the delicious pickle kissed the pickle with a fine the delicious pickle ?	NG
is it true that the fine pickled floor ate the fine pickled pickled chief of staff ?	GR
in floor understood a president .	NG
the delicious perplexed perplexed president kissed pickled fine chief of staff !	NG
a under pickle pickled a fine chief of staff on the pickled floor under a sandwich on a sandwich !	NG
the floor ate the perplexed delicious delicious pickled chief of staff .	GR
is it true that the the floor in the perplexed chief of staff pickled the pickle ?	NG
is it true that a pickle in the pickled pickle pickled a president ?	GR
perplexed chief of staff ate the floor on the chief of staff .	NG
is it true that a pickle understood the sandwich on a pickle with a perplexed floor under every pickle in a sandwich ?	GR
is it true that a pickled pickle wanted every president ?	GR
is it true that a perplexed president pickled the sandwich ?	GR
the pickle understood a president !	GR
the a pickled floor wanted the sandwich !	NG
pickled chief of staff under a president in every sandwich under the floor in every perplexed pickle kissed a delicious pickle !	NG
is it true that a president ate the pickle ?	GR
the sandwich pickled a pickle with the perplexed pickle perplexed a president .	NG
the on fine chief of staff ate the floor !	NG
is it true that every sandwich in a chief of staff under a president kissed the president ?	GR
a delicious president wanted the pickled pickled delicious pickled president .	GR
a pickle on a floor pickled the floor with every sandwich pickled the chief of staff !	NG
a delicious chief of staff under the pickle kissed the delicious delicious floor .	GR
every chief of staff ate a pickled floor !	GR
the floor understood a chief of staff !	GR
is it true that the pickle ate the pickle under a chief of staff in the president with a pickle ?	GR
the chief of staff understood the pickled perplexed sandwich !	GR
a pickled chief of staff under a president kissed the fine pickled chief of staff !	GR
is it true that the pickle with the perplexed pickle understood a chief of staff ?	GR
a pickled pickle understood a pickled chief of staff .	GR
a chief of staff on every pickle in the chief of staff on a president in a delicious sandwich .	NG
a floor understood the perplexed pickle with every president .	GR
a sandwich under the president !	NG
the perplexed pickled pickle under the delicious president with the fine sandwich on the president under under pickled fine delicious fine fine perplexed chief of staff ate a sandwich !	NG
is it true that the pickle on a fine fine delicious perplexed chief of staff pickled a chief of staff on on floor ?	NG
on floor kissed the chief of staff !	NG
delicious delicious delicious sandwich ate a floor !	NG
on pickle understood the perplexed floor !	NG
the chief of staff with ate sandwich kissed a delicious chief of staff .	NG
a president pickled fine president .	NG
is it true that the floor on a fine pickled fine delicious floor kissed a president ?	GR
pickled floor pickled every delicious fine delicious delicious president with the president in every pickle with the chief of staff with the sandwich !	NG
a delicious pickled delicious floor pickled the delicious sandwich in every pickle .	GR
is it true that the delicious floor pickled a chief of staff ?	GR
is it true that the fine in sandwich kissed the floor ?	NG
is it true that a chief of staff pickled a floor ?	GR
every pickled floor ate a sandwich !	GR
every fine perplexed fine delicious delicious pickle pickled the chief of staff .	GR
is it true that the pickle kissed a sandwich ?	GR
is it true that a pickled floor understood fine chief of staff ?	NG
is it true that the floor delicious the pickle ?	NG
the fine pickle understood the sandwich .	GR
a president understood the president understood every fine pickle !	NG
every pickle pickled the pickle on a president under a pickled pickle .	GR
the pickle wanted a chief of staff .	GR
a floor with a perplexed perplexed president under a sandwich with every floor understood a pickled perplexed sandwich .	GR
the floor perplexed the floor !	NG
the sandwich wanted every sandwich !	GR
every chief of staff kissed a perplexed president .	GR
the delicious pickle ate a sandwich .	GR
is it true that every delicious pickled fine pickle in a delicious president kissed the chief of staff ?	GR
is it true that the president ate a president ?	GR
the president kissed the perplexed delicious delicious floor on every fine pickle .	GR
the floor pickled the chief of staff .	GR
kissed floor pickled a pickle .	NG
a delicious chief of staff delicious the pickle with a delicious chief of staff in a chief of staff wanted the president !	NG
a floor the the chief of staff .	NG
the fine pickle with the sandwich ate a sandwich !	GR
is it true that ate fine floor kissed the delicious pickle ?	NG
is it true that the sandwich understood the floor ?	GR
is it true that a pickle understood every perplexed delicious chief of staff ?	GR
a chief of staff understood a floor in a floor under delicious fine perplexed president !	NG
the floor ate the sandwich !	GR
is it true that understood sandwich ate the floor ?	NG
the chief of staff a the pickle !	NG
a perplexed perplexed president every every perplexed perplexed floor .	NG
is it true that the fine fine delicious fine delicious sandwich pickled the chief of staff ?	GR
the president ate every president !	GR
is it true that every fine sandwich kissed the pickled chief of staff ?	GR
is it true that a sandwich with every delicious floor in the president in a pickled chief of staff in the perplexed pickle under a floor wanted a perplexed perplexed floor ?	GR
the sandwich on a president under a pickle !	NG
every sandwich wanted every pickle .	GR
a delicious chief of staff ate every perplexed chief of staff on every sandwich under a chief of staff with a delicious fine delicious president !	GR
a pickle kissed the floor on a chief of staff under the fine pickle .	GR
is it true that the floor pickled every delicious pickle ?	GR
is it true that the delicious perplexed pickled floor wanted every on president ?	NG
the delicious delicious floor understood the floor .	GR
perplexed pickle understood a chief of staff !	NG
is it true that a floor ate perplexed chief of staff ?	NG
the pickle under the delicious floor pickled a perplexed delicious pickle !	GR
every floor wanted on pickle .	NG
is it true that a fine chief of staff kissed every floor ?	GR
a perplexed chief of staff understood pickled chief of staff !	NG
is it true that the pickled pickled floor kissed delicious delicious pickle ?	NG
a floor kissed the fine understood fine pickled president !	NG
a sandwich under the fine president under fine president under every pickle kissed the delicious chief of staff !	NG
every pickle pickled perplexed pickled president !	NG
a pickled sandwich pickled delicious sandwich on every pickle .	NG
a chief of staff wanted every pickled fine pickle !	GR
the sandwich with the pickle under the pickled pickled pickle on the delicious sandwich kissed a delicious pickle under a fine floor !	GR
is it true that the chief of staff on a delicious sandwich under the president in a perplexed pickled chief of staff on a perplexed pickled president in a chief of staff on a perplexed floor pickled the pickle in a delicious perplexed pickle ate the fine chief of staff ?	NG
a pickled chief of staff ate the floor !	GR
the sandwich with a chief of staff .	NG
is it true that a pickled chief of staff kissed the sandwich ?	GR
the president under a chief of staff ate on fine fine president .	NG
a pickled sandwich on a perplexed floor kissed a chief of staff in a chief of staff under the perplexed chief of staff with the pickle .	GR
delicious chief of staff wanted a sandwich .	NG
is it true that the pickle ate a pickle ?	GR
a fine pickle kissed ate delicious floor .	NG
the chief of staff understood the chief of staff on the perplexed pickle on the president in a pickled president with the delicious president in every sandwich under the floor under a pickle in a pickled president .	GR
a perplexed sandwich with the pickle wanted the pickle .	GR
the president pickled the delicious a pickle .	NG
is it true that fine perplexed pickle understood a delicious pickled delicious chief of staff ?	NG
under pickled president under the fine delicious president in the sandwich pickled a chief of staff .	NG
the pickled fine perplexed pickle under a understood chief of staff wanted the president !	NG
the floor ate with perplexed pickle .	NG
is it true that in pickle with a pickle ate a sandwich ?	NG
a president understood the floor kissed every pickle in the pickle in a perplexed floor on the delicious perplexed pickle .	NG
a president under a floor in the perplexed chief of staff in every delicious perplexed president under a pickled chief of staff kissed every chief of staff .	GR
is it true that a pickle on the sandwich in a pickle wanted a delicious sandwich ?	GR
the chief of staff under the perplexed floor !	NG
pickled president pickled the pickle .	NG
a floor under the sandwich understood a perplexed pickle !	GR
every president under every president ate a floor .	GR
a delicious delicious president pickled with chief of staff on the chief of staff with the pickle with every president .	NG
is it true that a chief of staff in a pickle understood the pickled sandwich ?	GR
is it true that the sandwich kissed every sandwich ?	GR
the sandwich kissed the sandwich !	GR
the sandwich a the delicious chief of staff with a pickle on a chief of staff !	NG
a sandwich understood a sandwich in the pickled president on the pickle .	GR
a chief of staff wanted the fine a perplexed chief of staff .	NG
a chief of staff with a pickle in the chief of staff kissed the president .	GR
ate chief of staff kissed every floor !	NG
is it true that a sandwich wanted the floor under pickled floor ?	NG
is it true that the president wanted understood chief of staff ?	NG
is it true that the fine floor wanted pickled pickle ?	NG
is it true that a pickle ate a perplexed pickle in a pickled floor with every president ?	GR
is it true that the floor with the floor under a chief of staff on the sandwich with the delicious floor pickled a fine chief of staff under a president ?	GR
is it true that the fine fine pickled pickled floor pickled a perplexed chief of staff ?	GR
the floor understood a pickle .	GR
a fine pickled floor understood the president .	GR
the fine delicious pickled chief of staff kissed the sandwich in a pickled pickle !	GR
a perplexed pickled floor perplexed every chief of staff !	NG
is it true that the perplexed sandwich under the delicious president under a president the a president ?	NG
a chief of staff on the pickle .	NG
a perplexed chief of staff wanted the pickle on a floor in every chief of staff .	GR
is it true that every chief of staff understood the delicious president ?	GR
is it true that a pickle wanted perplexed floor ?	NG
a delicious perplexed pickled president kissed ate pickled delicious perplexed president in a chief of staff .	NG
the fine sandwich kissed the sandwich .	GR
the fine pickled floor a the pickle .	NG
the president with the pickle pickled every president .	GR
is it true that the chief of staff under a sandwich ?	NG
a president wanted a president on a sandwich .	GR
a pickle understood the pickled sandwich !	GR
the fine floor kissed a delicious perplexed president .	GR
is it true that the president ate the president under a pickle with kissed floor ?	NG
a president wanted a fine floor with a floor in a sandwich .	GR
the floor wanted the sandwich !	GR
every perplexed chief of staff ate the fine pickled pickle !	GR
a sandwich in the floor ate the pickled floor with the pickled fine delicious fine fine perplexed delicious fine president with a president with the delicious fine pickle !	GR
a fine fine president kissed the fine sandwich !	GR
every pickled president pickled the pickled delicious chief of staff !	GR
every perplexed floor pickled the floor .	GR
every sandwich ate a president .	GR
the floor on the chief of staff pickled a fine pickle .	GR
every pickled pickle kissed a president !	GR
every floor wanted the delicious perplexed president .	GR
is it true that the chief of staff under the chief of staff ?	NG
the pickle pickled the fine president .	GR
a pickled pickled pickle with a chief of staff under the perplexed sandwich kissed the sandwich !	GR
the chief of staff understood the perplexed pickled in pickle !	NG
a pickle ate pickled fine president !	NG
the pickle kissed every sandwich .	GR
the delicious chief of staff wanted in floor !	NG
is it true that a delicious fine chief of staff in a sandwich under every pickled president in a pickle with every chief of staff under a sandwich in a pickle in a president in a pickled fine perplexed sandwich under the fine pickled delicious perplexed fine chief of staff wanted a delicious pickled fine fine pickle ?	GR
the chief of staff ate perplexed pickle !	NG
pickled president ate a sandwich .	NG
ate pickled pickle pickled the sandwich .	NG
is it true that the perplexed president a every pickle ?	NG
ate chief of staff understood a pickle !	NG
kissed delicious floor wanted a chief of staff !	NG
is it true that the under president understood a sandwich ?	NG
a sandwich in with delicious pickle on a sandwich on a fine pickled fine pickle in the president kissed the president !	NG
kissed fine sandwich wanted a perplexed pickled president .	NG
is it true that the pickled pickled president on the delicious president ?	NG
the fine chief of staff understood a pickled wanted pickled chief of staff .	NG
is it true that every president understood every pickled president ?	GR
is it true that a sandwich pickled a delicious president ?	GR
the floor under every pickle on every chief of staff with a perplexed president with every pickled president wanted the sandwich .	GR
the chief of staff kissed every floor !	GR
every chief of staff wanted the sandwich !	GR
the pickle wanted a the floor .	NG
is it true that a sandwich wanted the delicious president ?	GR
under president understood a president .	NG
is it true that ate pickle kissed the pickle ?	NG
the perplexed fine chief of staff pickled a pickle .	GR
a fine chief of staff ate the president !	GR
is it true that a perplexed president wanted the chief of staff ?	GR
is it true that the pickle wanted the delicious perplexed floor understood every floor ?	NG
a pickled sandwich with a fine sandwich ate every delicious chief of staff in the president with a delicious pickle .	GR
kissed pickle understood the delicious pickle .	NG
is it true that the perplexed sandwich on a sandwich under every president in a pickled pickled sandwich ate the president with a chief of staff under the sandwich ?	GR
a chief of staff understood kissed pickle with every sandwich !	NG
is it true that a president pickled the pickle with the floor ?	GR
the pickle ate every pickle !	GR
a sandwich pickled a chief of staff .	GR
the president wanted a delicious pickle under a president on every chief of staff with the pickle !	GR
is it true that the pickled chief of staff wanted a president ?	GR
understood president ate a delicious chief of staff !	NG
a sandwich kissed delicious chief of staff !	NG
every pickled perplexed pickle wanted the fine floor .	GR
is it true that a floor in every pickle ?	NG
understood sandwich under a pickle ate a pickle !	NG
a chief of staff ate a fine floor under a floor .	GR
a floor ate pickled chief of staff .	NG
a pickle understood a sandwich in every president .	GR
is it true that the floor delicious every president ?	NG
the delicious pickled sandwich in a floor understood a president .	GR
a sandwich ate every sandwich .	GR
a perplexed president ate every sandwich .	GR
the chief of staff under a delicious pickle under in chief of staff in the pickle under a pickle wanted the sandwich !	NG
every pickled floor pickled the chief of staff !	GR
is it true that a floor on a floor understood the pickle ?	GR
is it true that every delicious president ate every sandwich ?	GR
the delicious fine pickle in the president under a pickled fine sandwich under a sandwich ate a president !	GR
is it true that a fine floor on a floor fine a chief of staff under a floor ?	NG
the chief of staff ate a perplexed fine delicious pickled pickle kissed the president .	NG
is it true that the delicious perplexed chief of staff understood the sandwich ?	GR
the floor under the fine chief of staff kissed the floor on a chief of staff !	GR
the pickle pickled in pickle in a floor !	NG
the perplexed perplexed fine pickle ate a pickled floor !	GR
the perplexed president kissed every pickle !	GR
the floor understood the president !	GR
every perplexed sandwich kissed a president .	GR
is it true that a sandwich pickled a president ?	GR
the floor in a chief of staff ate fine sandwich !	NG
a president wanted wanted delicious floor .	NG
every president on a pickled pickle with a perplexed floor pickled a pickle !	GR
a delicious fine sandwich in a sandwich !	NG
the pickle pickled the president !	GR
is it true that every fine chief of staff ate a sandwich ?	GR
is it true that the pickled pickled sandwich under the sandwich understood every floor in a floor ?	GR
the pickled fine president under every floor .	NG
is it true that the pickle on every delicious sandwich understood a perplexed president ?	GR
the floor pickled every perplexed delicious delicious pickled fine pickle with the fine perplexed pickle under a sandwich under a pickle !	GR
is it true that a pickle with the chief of staff on a president under the pickled perplexed fine floor under wanted president wanted every floor ?	NG
a president ate the floor !	GR
the floor with a president in the perplexed president in a perplexed chief of staff ate a sandwich with a sandwich .	GR
a delicious floor pickled the chief of staff .	GR
a president understood a perplexed delicious floor under the sandwich in the delicious pickled delicious fine sandwich !	GR
a floor ate a perplexed pickle !	GR
is it true that every chief of staff wanted a in sandwich ?	NG
a pickled sandwich in the perplexed fine perplexed delicious chief of staff in a sandwich pickled the floor .	GR
the pickle ate a pickled chief of staff .	GR
every floor pickled pickled president !	NG
is it true that a pickle delicious the delicious chief of staff ?	NG
the a perplexed sandwich understood the floor .	NG
the president understood the president wanted the chief of staff !	NG
the chief of staff understood the chief of staff !	GR
a president fine a chief of staff .	NG
wanted floor pickled the floor .	NG
is it true that every pickled pickled floor pickled every perplexed floor ?	GR
the floor understood the the perplexed pickle .	NG
the perplexed pickle under every floor under a chief of staff in a pickle pickled the pickle with a delicious pickle wanted a floor with the fine sandwich on the pickle !	NG
the delicious delicious floor kissed the perplexed delicious chief of staff !	GR
a perplexed sandwich understood the pickle .	GR
is it true that a delicious perplexed pickle wanted a floor ?	GR
is it true that a sandwich understood a perplexed pickled pickled perplexed perplexed pickle ?	GR
under chief of staff understood every perplexed president with a floor .	NG
the pickled chief of staff in the chief of staff with a floor with the floor in the floor understood a pickled chief of staff in a chief of staff !	GR
is it true that every pickled sandwich in a floor with every chief of staff in every sandwich pickled wanted chief of staff ?	NG
is it true that a chief of staff wanted a president under every sandwich ?	GR
a floor under a chief of staff .	NG
the fine fine floor kissed every floor .	GR
the floor in a pickle delicious a sandwich pickled the floor on every pickled chief of staff !	NG
a floor pickled pickled floor .	NG
the floor fine a fine floor !	NG
the pickle ate on fine floor !	NG
the president ate kissed sandwich !	NG
the pickled pickle kissed a perplexed sandwich .	GR
a sandwich understood the chief of staff .	GR
a perplexed president ate a perplexed chief of staff on every pickle .	GR
a pickled fine chief of staff understood wanted sandwich under a delicious perplexed pickled sandwich under a chief of staff on a pickle .	NG
a delicious delicious pickle on a sandwich with every floor pickled a fine pickled chief of staff !	GR
the president kissed the delicious under fine chief of staff under the fine president in a president .	NG
the chief of staff with a fine chief of staff on a perplexed pickle ate a perplexed fine president .	GR
is it true that a sandwich kissed the sandwich ?	GR
every pickled president fine a pickled president with every sandwich .	NG
is it true that the floor kissed a pickle under every sandwich ?	GR
pickled president understood the chief of staff .	NG
the pickle understood a president .	GR
a chief of staff kissed a sandwich !	GR
the fine delicious the pickle understood the sandwich !	NG
the pickled chief of staff with a perplexed pickle in the pickled delicious perplexed pickle under the perplexed chief of staff in a fine fine delicious fine sandwich kissed a sandwich !	GR
a chief of staff understood under pickle !	NG
is it true that the perplexed president a the president ?	NG
is it true that a perplexed sandwich the the pickle ?	NG
every chief of staff a the fine sandwich !	NG
is it true that a perplexed delicious floor understood a delicious sandwich ?	GR
with floor ate a president !	NG
a fine floor with a pickle ate fine perplexed president .	NG
is it true that the sandwich fine a fine chief of staff ?	NG
the fine floor wanted the sandwich on a floor wanted every perplexed floor with a chief of staff .	NG
a chief of staff kissed the perplexed delicious chief of staff .	GR
ate pickled sandwich on every pickle ate the perplexed sandwich .	NG
a fine chief of staff pickled a pickle with a pickle with the pickle with the chief of staff .	GR
a pickled floor wanted a the perplexed president .	NG
the sandwich ate a pickled president under the floor !	GR
is it true that a delicious sandwich under every president with fine sandwich wanted every pickle ?	NG
is it true that the chief of staff wanted a chief of staff with the delicious pickle ?	GR
every floor kissed kissed sandwich in every sandwich !	NG
a pickle wanted a fine floor in a president with a president with a president !	GR
the delicious kissed floor wanted a president !	NG
every fine chief of staff pickled every chief of staff .	GR
the pickle the a perplexed chief of staff .	NG
wanted pickle ate a president under a chief of staff under a pickle .	NG
every pickled pickled fine sandwich pickled understood pickle !	NG
is it true that a sandwich kissed a pickle ?	GR
is it true that every sandwich ate a sandwich with fine president ?	NG
the delicious fine sandwich pickled a perplexed fine pickle !	GR
a chief of staff fine the president !	NG
the pickle the the president !	NG
is it true that the perplexed fine pickled sandwich ate a sandwich ?	GR
a sandwich pickled wanted pickle .	NG
every floor pickled a president !	GR
a floor kissed every wanted fine delicious perplexed pickle !	NG
a fine chief of staff kissed a delicious pickle .	GR
is it true that the delicious chief of staff pickled a sandwich ?	GR
the floor the the president !	NG
is it true that wanted president ate a perplexed chief of staff ?	NG
the pickled pickle ate a delicious pickled pickled chief of staff with the floor .	GR
is it true that every perplexed sandwich wanted every sandwich ?	GR
the sandwich ate a delicious pickled pickle .	GR
every floor wanted every pickled fine president with a fine sandwich !	GR
is it true that every floor perplexed the pickled president ?	NG
is it true that understood pickle understood every floor ?	NG
a pickle on every with chief of staff with the pickled chief of staff pickled a pickle !	NG
every perplexed floor on a pickle on the chief of staff under a perplexed delicious floor wanted the president with a understood president !	NG
a delicious president kissed the floor !	GR
is it true that ate chief of staff wanted a sandwich ?	NG
is it true that a president wanted delicious sandwich ?	NG
is it true that the understood pickle in a perplexed fine pickle with a delicious chief of staff understood the chief of staff ?	NG
the sandwich pickled every president !	GR
a perplexed floor wanted the sandwich the the chief of staff !	NG
a sandwich ate the fine pickled delicious sandwich .	GR
the floor pickled a every sandwich .	NG
every floor ate kissed chief of staff .	NG
every pickle kissed the delicious pickled perplexed perplexed floor .	GR
the delicious sandwich kissed a president with a pickled perplexed floor .	GR
a perplexed delicious floor kissed under pickle .	NG
is it true that the delicious pickled perplexed pickle wanted a chief of staff ?	GR
is it true that every perplexed pickle in a floor in a floor understood a chief of staff ?	GR
a pickled every sandwich wanted every president on the pickle !	NG
the pickle understood a president !	GR
the pickled fine every chief of staff under the pickled pickle pickled a chief of staff !	NG
a president on a delicious president in the pickle under a sandwich .	NG
every sandwich understood a perplexed pickle !	GR
ate pickle wanted the floor .	NG
is it true that the chief of staff on a floor ?	NG
is it true that a president ate a pickled pickle under the fine perplexed delicious perplexed chief of staff under the pickled pickled sandwich under a president with a chief of staff under a fine sandwich on every sandwich ?	GR
is it true that every delicious fine chief of staff wanted the delicious pickled chief of staff on the president ?	GR
a pickle in a sandwich ate the president .	GR
the chief of staff under a president understood a pickled pickle under the sandwich !	GR
a pickle understood the every perplexed floor !	NG
is it true that the pickle a a delicious floor ?	NG
the sandwich kissed every fine perplexed floor with a fine sandwich with the pickle .	GR
the president kissed a pickle !	GR
is it true that the pickled president ate a chief of staff ?	GR
in fine sandwich pickled the sandwich !	NG
delicious pickled perplexed pickled pickled delicious perplexed pickle understood a perplexed chief of staff !	NG
a floor with a floor kissed the pickled president !	GR
pickled chief of staff pickled the delicious president .	NG
in president understood the fine pickle .	NG
is it true that the delicious pickle under a sandwich on a delicious perplexed president ate the floor ?	GR
a pickle the the chief of staff .	NG
a sandwich in a pickle under every pickle in the pickled pickled delicious floor under a perplexed perplexed delicious fine president ate the floor with the president .	GR
the fine wanted chief of staff pickled the president .	NG
in fine sandwich pickled the fine perplexed pickle .	NG
is it true that every pickled delicious pickle the a delicious floor understood a sandwich ?	NG
is it true that a sandwich wanted the sandwich ?	GR
is it true that a president pickled a perplexed president ?	GR
the pickled fine chief of staff wanted the president !	GR
a sandwich with the chief of staff with the sandwich !	NG
is it true that a under chief of staff ate a chief of staff ?	NG
a fine chief of staff on the delicious president kissed a pickle with every floor in every delicious pickle with every pickle in the fine perplexed sandwich with a sandwich !	GR
is it true that the chief of staff with a pickle on the chief of staff with a president ate a pickled pickled floor ?	GR
the perplexed pickled pickled perplexed delicious chief of staff ate the sandwich .	GR
a president fine a delicious pickle !	NG
a delicious floor kissed the in pickled president !	NG
on perplexed fine president wanted a pickle .	NG
the delicious president with the fine president on the delicious pickle delicious the floor .	NG
every president with a pickle .	NG
the delicious president under a floor pickled a president with every floor in a sandwich in the perplexed chief of staff with the sandwich .	GR
a president in a delicious president on the pickled pickle under the delicious pickled sandwich in the fine delicious perplexed chief of staff in a president on a delicious chief of staff ate the with sandwich !	NG
the perplexed pickled chief of staff understood the perplexed delicious sandwich under a floor .	GR
a floor the a president .	NG
a pickle with the floor wanted a chief of staff !	GR
is it true that a president in the chief of staff ?	NG
the perplexed president the a perplexed floor !	NG
a sandwich pickled a pickled delicious delicious pickled sandwich !	GR
the chief of staff under a president kissed every sandwich under a sandwich on the perplexed pickle in the pickled president understood the chief of staff !	NG
is it true that the sandwich on the sandwich kissed the chief of staff ?	GR
a sandwich ate a sandwich on pickled president !	NG
is it true that the floor understood a sandwich ?	GR
is it true that every chief of staff wanted ate perplexed floor under the president ?	NG
the sandwich kissed perplexed pickle .	NG
is it true that the perplexed pickled chief of staff understood the president ?	GR
on floor in every pickled sandwich on the floor on a perplexed sandwich understood the president .	NG
the fine sandwich understood perplexed floor in a pickle .	NG
the chief of staff wanted a delicious pickled chief of staff in a pickled chief of staff in a perplexed sandwich !	GR
the president understood every chief of staff .	GR
is it true that a president pickled the president under a pickle ?	GR
every perplexed floor under the sandwich in the chief of staff in the fine president in a delicious pickle in the pickle with the fine sandwich understood the pickle !	GR
a president kissed the president !	GR
a chief of staff understood pickled sandwich .	NG
a fine chief of staff wanted the chief of staff .	GR
a floor ate the perplexed chief of staff .	GR
every fine chief of staff under the pickled delicious pickled sandwich ate the perplexed floor .	GR
is it true that a fine fine floor understood a sandwich with the perplexed sandwich ?	GR
is it true that every pickled pickle with perplexed president understood the delicious sandwich ?	NG
the pickled fine sandwich under a president in the chief of staff in a fine chief of staff understood the sandwich !	GR
a president delicious a pickle on a pickle .	NG
is it true that perplexed floor kissed every president ?	NG
is it true that a perplexed delicious in floor pickled a sandwich with every chief of staff ?	NG
the chief of staff understood a chief of staff !	GR
a perplexed chief of staff wanted a pickle on a pickled sandwich with a chief of staff .	GR
a chief of staff understood a ate pickled perplexed pickle !	NG
every floor in the pickle in the delicious pickle under the floor under the floor ate a floor !	GR
a fine sandwich understood the chief of staff .	GR
a floor pickled every delicious pickled chief of staff under the fine fine fine sandwich !	GR
is it true that the president fine the floor kissed the floor ?	NG
is it true that a sandwich ate a the sandwich ?	NG
the president under a perplexed fine floor under the perplexed delicious president kissed ate chief of staff with every delicious president !	NG
the delicious fine delicious pickled pickle understood on sandwich !	NG
is it true that the president pickled a delicious president with the perplexed pickled chief of staff with a sandwich in a perplexed delicious fine delicious sandwich ?	GR
a pickled chief of staff wanted the chief of staff .	GR
is it true that the sandwich fine the president ?	NG
kissed floor wanted every delicious fine floor on every pickled delicious chief of staff on a chief of staff in a fine pickle !	NG
the floor the a pickle in the pickled chief of staff !	NG
the pickled perplexed pickled pickled president wanted the perplexed perplexed delicious sandwich under every perplexed sandwich under a sandwich with a pickled perplexed president .	GR
a perplexed delicious president in the chief of staff in a chief of staff ate every sandwich .	GR
is it true that the pickle in every sandwich under the floor in the fine floor ate a fine pickle in delicious president under the fine perplexed pickled chief of staff ?	NG
the sandwich kissed a fine president !	GR
the president under the floor on a chief of staff wanted the perplexed fine pickled pickle !	GR
is it true that the floor understood the delicious chief of staff ?	GR
is it true that under floor wanted the floor under a sandwich ?	NG
is it true that the chief of staff under the chief of staff ?	NG
pickled president ate a perplexed sandwich !	NG
kissed chief of staff under a sandwich under the floor pickled the chief of staff .	NG
the chief of staff the a pickle .	NG
the perplexed sandwich wanted a pickle .	GR
is it true that every pickle pickled kissed chief of staff on every pickled pickled pickle ?	NG
the pickled fine fine pickled fine perplexed floor under the delicious floor with a president wanted the pickle .	GR
a chief of staff with a pickled sandwich under every sandwich .	NG
every perplexed perplexed pickle wanted every pickle in every delicious pickled pickle pickled the pickle !	NG
a fine floor pickled a floor in the floor !	GR
is it true that a floor fine a sandwich ?	NG
a president ate wanted delicious floor !	NG
every president with a floor in the pickled floor ate every fine floor !	GR
a floor with a perplexed floor understood delicious president !	NG
is it true that a chief of staff wanted the delicious chief of staff ?	GR
is it true that a pickled fine pickled pickled chief of staff a a sandwich ?	NG
is it true that a pickled pickled sandwich under a sandwich under the floor ate the pickled sandwich ?	GR
is it true that every delicious pickle ate every floor ?	GR
every delicious floor wanted a fine pickle with the in delicious president in the president !	NG
is it true that on pickle understood a floor in every floor under the pickle ?	NG
a chief of staff understood the wanted president !	NG
the delicious sandwich kissed a pickled perplexed delicious sandwich .	GR
a pickle kissed a every pickled delicious chief of staff .	NG
the the president kissed every chief of staff !	NG
the delicious sandwich pickled every chief of staff under a sandwich !	GR
a chief of staff under a delicious president wanted a president under a pickled sandwich .	GR
the perplexed a floor understood every pickled perplexed pickle .	NG
is it true that every pickle wanted the president with the delicious floor in a perplexed delicious perplexed pickled delicious floor ?	GR
fine chief of staff ate a floor on the pickle .	NG
is it true that every floor kissed a perplexed president ?	GR
is it true that every chief of staff wanted the perplexed in chief of staff ?	NG
is it true that a fine pickle on a pickled president ate the president under a perplexed chief of staff on the chief of staff ?	GR
every president ate the fine perplexed delicious chief of staff !	GR
the pickled sandwich on the sandwich kissed the president .	GR
is it true that the chief of staff kissed the in president ?	NG
every fine pickle kissed the sandwich with delicious sandwich !	NG
a pickle kissed a perplexed sandwich .	GR
a fine chief of staff wanted every perplexed floor in every president in a chief of staff on a fine sandwich in a pickled floor .	GR
perplexed perplexed perplexed chief of staff pickled a pickle !	NG
every fine fine president pickled the president .	GR
every delicious sandwich pickled the perplexed delicious pickled pickled perplexed chief of staff in a fine president .	GR
a fine sandwich on the pickled fine perplexed president wanted a perplexed chief of staff with a delicious chief of staff !	GR
a perplexed pickle perplexed every sandwich !	NG
a pickle pickled the floor !	GR
a sandwich wanted a sandwich !	GR
is it true that a fine floor with every sandwich ate every perplexed floor ?	GR
a sandwich ate the sandwich on the floor on the sandwich on the delicious delicious president !	GR
perplexed sandwich pickled a pickle .	NG
ate floor ate a president !	NG
the president ate a fine delicious president .	GR
is it true that delicious sandwich pickled a delicious delicious sandwich ?	NG
is it true that the floor kissed the president ?	GR
is it true that a sandwich on every pickle ?	NG
is it true that perplexed pickle on every pickle pickled a floor ?	NG
every pickle kissed a pickle under the president ate the sandwich in a sandwich with the fine pickle .	NG
is it true that a perplexed president in a chief of staff with a chief of staff pickled a sandwich ?	GR
a sandwich wanted a perplexed understood delicious pickled sandwich !	NG
a chief of staff ate a floor under a pickle !	GR
a pickled chief of staff under a chief of staff wanted a sandwich !	GR
the sandwich in fine chief of staff pickled a president .	NG
a fine chief of staff understood a president with the chief of staff in a fine floor .	GR
is it true that a president understood the perplexed fine floor under every sandwich in a floor ?	GR
every delicious chief of staff pickled perplexed president !	NG
every sandwich pickled the sandwich !	GR
a floor in every floor on a sandwich wanted the on sandwich .	NG
is it true that the president with every floor ate perplexed fine president ?	NG
the delicious president ate a pickle !	GR
the pickle on the chief of staff with the chief of staff with a chief of staff with the sandwich in a pickle understood the sandwich .	GR
the floor kissed the perplexed perplexed sandwich .	GR
is it true that with fine sandwich understood the floor ?	NG
a a delicious perplexed president wanted the floor under a pickle with the president !	NG
pickled delicious president in the floor wanted a president !	NG
is it true that a fine fine perplexed perplexed chief of staff pickled a perplexed sandwich ?	GR
the pickled pickle pickled the chief of staff !	GR
a fine president ate the pickled perplexed sandwich .	GR
the sandwich kissed the fine pickled chief of staff fine the chief of staff in a sandwich with every floor !	NG
a floor pickled the pickle !	GR
the pickled chief of staff wanted the perplexed fine pickle .	GR
is it true that a fine perplexed pickle wanted the sandwich ?	GR
is it true that the floor in a chief of staff with every delicious delicious chief of staff wanted a floor under the president ?	GR
the fine chief of staff kissed every sandwich !	GR
is it true that the delicious perplexed perplexed sandwich wanted the sandwich on a floor ?	GR
every pickle understood the president .	GR
is it true that every pickle kissed the a sandwich ?	NG
a fine sandwich kissed a chief of staff !	GR
is it true that a chief of staff wanted the president ?	GR
is it true that the pickle in pickled president pickled the sandwich ?	NG
the chief of staff wanted the delicious pickled pickle .	GR
a pickle wanted a chief of staff .	GR
a president ate the fine pickled pickle .	GR
is it true that a floor in a floor understood the floor ?	GR
is it true that pickled perplexed chief of staff understood the sandwich ?	NG
is it true that every fine delicious chief of staff understood the president ?	GR
a president on a floor on with chief of staff understood a floor .	NG
is it true that kissed pickle pickled a sandwich ?	NG
a fine perplexed pickle understood a pickled pickle !	GR
is it true that a ate perplexed pickle ate a floor ?	NG
is it true that a floor pickled every president ?	GR
a president with the ate fine perplexed president ate the fine sandwich !	NG
perplexed perplexed pickle ate a fine sandwich under the fine floor !	NG
is it true that the floor kissed the sandwich ?	GR
a pickled delicious president kissed a president !	GR
a pickle pickled a pickle !	GR
the fine perplexed pickled chief of staff ate the president .	GR
understood pickle pickled the pickled perplexed fine floor !	NG
is it true that the fine floor understood pickled pickle with every sandwich ?	NG
is it true that the perplexed chief of staff ate the perplexed delicious pickle under a delicious floor in a president under the sandwich in the perplexed floor with a chief of staff in a sandwich on the delicious delicious fine sandwich under every pickled fine floor under a sandwich on the pickle on the fine delicious floor ?	GR
in pickled fine sandwich pickled a chief of staff .	NG
the fine chief of staff pickled a pickle .	GR
a delicious sandwich understood kissed floor .	NG
a president ate a floor !	GR
a president a every pickled president with a pickle in a floor ate every perplexed pickled chief of staff .	NG
the chief of staff with a chief of staff understood a fine chief of staff .	GR
is it true that the sandwich kissed a floor ?	GR
is it true that a pickle wanted a president ?	GR
a pickle wanted the pickled perplexed pickle under a delicious sandwich .	GR
ate sandwich kissed the floor .	NG
every perplexed chief of staff understood every chief of staff .	GR
a sandwich kissed a delicious chief of staff in the pickle .	GR
is it true that the president on every pickle on a sandwich kissed in pickle ?	NG
is it true that a sandwich ate a pickled perplexed delicious pickle with every pickle on the chief of staff under a sandwich under a floor every the delicious pickle ?	NG
is it true that perplexed pickled sandwich pickled the fine pickled chief of staff ?	NG
a president understood the president in the pickle with every floor in a pickled pickle in every sandwich .	GR
a perplexed pickled chief of staff kissed a delicious fine fine chief of staff .	GR
a perplexed chief of staff wanted a chief of staff .	GR
under chief of staff kissed a chief of staff !	NG
a perplexed pickle ate the sandwich !	GR
a pickled fine chief of staff ate the pickled pickled pickled floor !	GR
every pickle ate a pickle !	GR
every perplexed pickled floor wanted the sandwich !	GR
is it true that every floor wanted delicious pickle ?	NG
the perplexed president wanted a pickle under the perplexed pickle under the pickle on the pickle !	GR
the sandwich in a fine president pickled the delicious pickle !	GR
is it true that on sandwich pickled a pickled president ?	NG
a fine pickle under a floor ate ate perplexed chief of staff !	NG
the pickle pickled the chief of staff .	GR
is it true that a chief of staff under the fine president pickled every floor ?	GR
a sandwich ate in sandwich !	NG
the sandwich wanted the in floor under the pickled sandwich !	NG
is it true that a delicious delicious chief of staff under the delicious chief of staff with every delicious pickle in the floor under every perplexed perplexed delicious delicious pickle wanted a floor ?	GR
a with delicious chief of staff with a sandwich pickled the chief of staff .	NG
a chief of staff understood in pickle !	NG
the pickled sandwich understood a pickled president !	GR
is it true that the perplexed floor under a sandwich pickled the president under the perplexed chief of staff with the president in the ate chief of staff ?	NG
under pickled floor understood a president .	NG
is it true that the fine chief of staff under the sandwich ?	NG
a chief of staff wanted a delicious chief of staff under a perplexed president !	GR
is it true that every pickle under the floor wanted a floor with the floor with the perplexed floor with the president on every perplexed pickled perplexed president with a pickle in every delicious delicious floor on a pickle ?	GR
is it true that a fine pickled perplexed pickled pickle with a chief of staff pickled the perplexed sandwich ?	GR
the perplexed president with the chief of staff under a sandwich in the floor under a perplexed president in the delicious perplexed floor kissed a sandwich on every fine fine pickle .	GR
pickled pickled delicious pickle understood the president !	NG
the pickle ate a fine chief of staff .	GR
the floor understood perplexed pickle with the delicious floor !	NG
the president in every sandwich with a president ate a pickle in a floor under a pickle in a president !	GR
a president pickled a delicious president .	GR
the floor on the delicious pickle kissed the fine delicious floor ate every perplexed sandwich !	NG
a pickled perplexed chief of staff on every fine perplexed fine sandwich in the pickle ate a chief of staff in the sandwich perplexed a chief of staff under every pickle !	NG
a delicious pickle pickled pickled pickled floor in the chief of staff under a president .	NG
is it true that with chief of staff wanted the fine pickle ?	NG
is it true that every president understood the president ?	GR
every floor understood a pickle .	GR
the chief of staff pickled a pickled fine fine president !	GR
a perplexed fine sandwich on a floor with the chief of staff kissed a pickle !	GR
a sandwich on the floor under a sandwich .	NG
every floor ate the delicious pickle on the delicious pickled chief of staff !	GR
a sandwich understood a perplexed fine pickle .	GR
a floor in a president with the chief of staff on the floor pickled the fine perplexed pickle !	GR
every floor under the chief of staff pickled the fine fine pickle .	GR
the delicious president wanted every president !	GR
a perplexed delicious delicious floor in the sandwich pickled the pickle !	GR
is it true that a president delicious the delicious pickled pickle wanted a delicious floor with the pickle ?	NG
a chief of staff on a chief of staff under the delicious perplexed pickled fine delicious sandwich pickled every floor !	GR
is it true that in president ate the fine fine floor on a sandwich ?	NG
is it true that every chief of staff understood understood pickled chief of staff ?	NG
is it true that a president on a fine pickle ?	NG
is it true that the pickled pickle wanted every pickle on every fine sandwich on a chief of staff under a chief of staff under the pickled perplexed perplexed pickle on the delicious sandwich ?	GR
is it true that the president understood a sandwich ?	GR
the delicious president kissed in fine president !	NG
is it true that the chief of staff pickled a perplexed chief of staff with a floor in a perplexed perplexed president with every delicious chief of staff under a pickled chief of staff with the president on a president ?	GR
the pickle in a president on the pickle with the delicious delicious pickled chief of staff understood a pickled floor .	GR
the pickled floor understood the perplexed pickled chief of staff .	GR
is it true that a chief of staff kissed every perplexed delicious chief of staff ?	GR
a president pickled a pickle !	GR
a floor wanted a pickle in a chief of staff with the chief of staff on the chief of staff !	GR
is it true that the floor with the pickle understood a with chief of staff ?	NG
every delicious president wanted the wanted fine chief of staff .	NG
the chief of staff ate the president under a sandwich on a pickled perplexed fine chief of staff !	GR
is it true that a sandwich fine the floor ?	NG
the pickled pickled a pickled floor ate every president !	NG
the chief of staff on the perplexed president wanted a president in a delicious pickled floor in the fine perplexed sandwich with the delicious pickle !	GR
a chief of staff wanted the pickled fine delicious floor with the floor with the pickled floor on the president with a chief of staff on the perplexed sandwich ate a chief of staff !	NG
the pickled pickle pickled the chief of staff .	GR
is it true that the pickle ate the floor ?	GR
is it true that a fine pickle the the perplexed floor ?	NG
is it true that the chief of staff understood the president ?	GR
the sandwich under the floor .	NG
every fine fine pickle ate a pickled perplexed pickle .	GR
